,Player,Nation,Pos,Squad,Age,Born,90s,Tkl_Tackles,TklW_Tackles,Def 3rd_Tackles,Mid 3rd_Tackles,Att 3rd_Tackles,Tkl_Vs Dribbles,Att_Vs Dribbles,Tkl%_Vs Dribbles,Past_Vs Dribbles,Blocks_Blocks,Sh_Blocks,Pass_Blocks,Int,Tkl+Int,Clr,Err
0,Marcos Acuña,ar  ARG,DF,Sevilla,31-063,1991,6.1,19,10,10,8,1,9,14,64.3,5,7,2,5,11,30,7,0
1,Álvaro Aguado,es  ESP,MF,Valladolid,26-243,1996,8.3,3,1,2,1,0,3,7,42.9,4,9,3,6,5,8,5,0
2,Joseph Aidoo,gh  GHA,DF,Celta Vigo,27-092,1995,14.0,26,17,17,8,1,8,12,66.7,4,14,7,7,11,37,48,0
3,Sergio Akieme,es  ESP,DF,Almería,25-014,1997,14.0,24,13,16,6,2,11,14,78.6,3,14,3,11,9,33,24,0
4,Paul Akouokou,ci  CIV,MF,Betis,25-010,1997,2.6,9,5,7,2,0,7,9,77.8,2,0,0,0,5,14,2,1
5,David Alaba,at  AUT,DF,Real Madrid,30-189,1992,12.9,7,5,3,2,2,5,8,62.5,3,8,5,3,11,18,21,1
6,Tomás Alarcón,cl  CHI,MF,Cádiz,23-345,1999,2.5,3,2,0,2,1,1,2,50.0,1,1,0,1,2,5,2,0
7,Jordi Alba,es  ESP,DF,Barcelona,33-284,1989,7.6,12,9,8,4,0,8,13,61.5,5,5,2,3,4,16,10,0
8,Raúl Albiol,es  ESP,DF,Villarreal,37-117,1985,12.9,13,9,7,5,1,7,8,87.5,1,9,9,0,9,22,60,0
9,Rubén Alcaraz,es  ESP,MF,Cádiz,31-243,1991,5.7,14,9,8,6,0,5,13,38.5,8,6,0,6,4,18,6,0
10,Omar Alderete,py  PAR,DF,Getafe,26-004,1996,1.5,0,0,0,0,0,0,3,0.0,3,1,1,0,2,2,9,0
11,Iván Alejo,es  ESP,"MF,FW",Cádiz,27-323,1995,7.3,22,15,11,7,4,13,26,50.0,13,12,1,11,2,24,5,1
12,Carles Aleñá,es  ESP,MF,Getafe,24-359,1998,11.4,11,8,4,2,5,3,21,14.3,18,9,0,9,2,13,11,0
13,Alejandro Alfaro,es  ESP,MF,Elche,20-198,2002,0.2,0,0,0,0,0,0,0,,0,0,0,0,0,0,0,0
14,Ángel Algobia,es  ESP,MF,Getafe,23-190,1999,4.0,15,6,10,5,0,11,14,78.6,3,7,3,4,1,16,2,0
15,Mohamed Ali Cho,fr  FRA,FW,Real Sociedad,18-345,2004,2.7,4,2,4,0,0,0,1,0.0,1,5,0,5,2,6,2,0
16,Domingos André Ribeiro Almeida,pt  POR,"MF,FW",Valencia,22-214,2000,7.8,14,7,4,7,3,4,7,57.1,3,5,0,5,5,19,4,0
17,Marcos Alonso,es  ESP,DF,Barcelona,32-002,1990,5.0,6,4,3,3,0,4,5,80.0,1,5,5,0,6,12,10,0
18,Gastón Álvarez,uy  URU,DF,Getafe,22-281,2000,4.8,11,8,8,3,0,6,12,50.0,6,5,3,2,9,20,15,0
19,Yeray Álvarez,es  ESP,DF,Athletic Club,27-340,1995,12.7,17,12,14,2,1,13,15,86.7,2,13,10,3,28,45,47,0
20,Amath,sn  SEN,"MF,FW",Mallorca,26-167,1996,2.7,7,4,4,0,3,2,2,100.0,0,1,0,1,0,7,1,0
21,Jordan Amavi,fr  FRA,DF,Getafe,28-296,1994,2.1,3,2,3,0,0,1,3,33.3,2,3,0,3,4,7,7,0
22,Fabrizio Angileri,ar  ARG,DF,Getafe,28-290,1994,5.7,7,5,4,2,1,5,11,45.5,6,7,3,4,6,13,8,0
23,Anuar,ma  MAR,"MF,FW",Valladolid,27-349,1995,2.3,4,4,0,1,3,0,0,,0,5,2,3,3,7,3,0
24,Mauro Arambarri,uy  URU,MF,Getafe,27-091,1995,5.7,7,4,3,3,1,1,11,9.1,10,10,3,7,5,12,7,0
25,Ronald Araújo,uy  URU,DF,Barcelona,23-298,1999,5.7,8,7,4,4,0,2,3,66.7,1,1,0,1,7,15,11,0
26,Roberto Arroyo,es  ESP,MF,Valladolid,19-127,2003,0.2,1,1,0,1,0,1,1,100.0,0,0,0,0,0,1,0,0
27,Santiago Arzamendia,py  PAR,"MF,DF",Cádiz,24-239,1998,2.8,3,2,2,1,0,3,8,37.5,5,7,0,7,0,3,6,1
28,Sergio Asenjo,es  ESP,GK,Valladolid,33-185,1989,5.0,0,0,0,0,0,0,0,,0,0,0,0,0,0,6,2
29,Marco Asensio,es  ESP,"MF,FW",Real Madrid,26-343,1996,2.1,5,3,3,2,0,2,4,50.0,2,1,0,1,0,5,1,0
30,Iago Aspas,es  ESP,FW,Celta Vigo,35-151,1987,12.5,0,0,0,0,0,0,5,0.0,5,5,0,5,4,4,9,0
31,Pierre-Emerick Aubameyang,ga  GAB,FW,Barcelona,33-195,1989,0.1,0,0,0,0,0,0,0,,0,0,0,0,0,0,0,0
32,Ezequiel Ávila,ar  ARG,"FW,MF",Osasuna,28-327,1994,9.3,4,3,2,2,0,3,10,30.0,7,4,0,4,4,8,6,0
33,Iddrisu Baba,gh  GHA,MF,Mallorca,26-342,1996,6.1,15,6,6,9,0,6,11,54.5,5,4,0,4,4,19,10,0
34,Srđan Babić,rs  SRB,DF,Almería,26-252,1996,12.5,11,6,8,3,0,5,10,50.0,5,7,6,1,7,18,31,0
35,Édgar Badía,es  ESP,GK,Elche,30-321,1992,15.0,1,0,1,0,0,1,1,100.0,0,0,0,0,0,1,8,2
36,Alex Baena,es  ESP,"MF,FW",Villarreal,21-163,2001,7.0,11,4,5,2,4,6,10,60.0,4,5,2,3,2,13,10,0
37,Alejandro Balde,es  ESP,DF,Barcelona,19-073,2003,10.8,17,13,10,5,2,8,12,66.7,4,12,1,11,6,23,7,0
38,Mikel Balenziaga,es  ESP,DF,Athletic Club,34-304,1988,0.5,2,2,0,1,1,2,2,100.0,0,0,0,0,1,3,1,0
39,Iván Balliu,al  ALB,DF,Rayo Vallecano,30-363,1992,15.0,18,12,9,9,0,4,8,50.0,4,7,1,6,13,31,37,1
40,Léo Baptistão,br  BRA,"FW,MF",Almería,30-126,1992,6.3,14,9,7,5,2,8,13,61.5,5,3,0,3,8,22,4,0
41,Keidi Bare,al  ALB,MF,Espanyol,25-124,1997,3.7,7,3,4,1,2,3,7,42.9,4,5,2,3,11,18,5,0
42,Kike Barja,es  ESP,"MF,FW",Osasuna,25-273,1997,3.2,3,1,1,1,1,0,2,0.0,2,1,0,1,2,5,1,0
43,Ander Barrenetxea,es  ESP,FW,Real Sociedad,21-003,2001,0.7,4,3,4,0,0,2,5,40.0,3,2,0,2,1,5,1,0
44,Pablo Barrios,es  ESP,MF,Atlético Madrid,19-198,2003,1.1,1,1,0,1,0,0,1,0.0,1,1,0,1,1,2,0,0
45,Rodrigo Battaglia,ar  ARG,MF,Mallorca,31-171,1991,6.6,11,4,6,5,0,6,11,54.5,5,12,7,5,5,16,16,0
46,Bebé,cv  CPV,FW,Rayo Vallecano,32-171,1990,0.7,0,0,0,0,0,0,2,0.0,2,1,0,1,0,0,0,0
47,Héctor Bellerín,es  ESP,DF,Barcelona,27-286,1995,1.6,2,0,0,2,0,2,3,66.7,1,2,0,2,3,5,2,0
48,Fran Beltrán,es  ESP,MF,Celta Vigo,23-330,1999,12.5,10,6,4,4,2,3,16,18.8,13,11,2,9,14,24,7,1
49,Karim Benzema,fr  FRA,FW,Real Madrid,35-011,1987,7.0,3,2,1,0,2,0,1,0.0,1,4,0,4,1,4,0,0
50,Yuri Berchiche,es  ESP,DF,Athletic Club,32-323,1990,5.9,14,9,8,4,2,9,15,60.0,6,9,2,7,12,26,18,1
51,Álex Berenguer,es  ESP,FW,Athletic Club,27-179,1995,11.6,27,16,8,10,9,12,23,52.2,11,14,1,13,2,29,5,0
52,Pedro Bigas,es  ESP,DF,Elche,32-106,1990,11.8,19,10,16,3,0,7,13,53.8,6,14,6,8,19,38,49,0
53,El Bilal Touré,ml  MLI,FW,Almería,21-088,2001,6.3,1,1,1,0,0,0,2,0.0,2,2,1,1,0,1,13,0
54,Blanco,es  ESP,MF,Cádiz,22-160,2000,1.8,6,4,5,1,0,4,6,66.7,2,5,0,5,1,7,3,0
55,Theo Bongonda,cd  COD,MF,Cádiz,27-040,1995,5.0,5,4,1,3,1,1,5,20.0,4,3,0,3,1,6,2,0
56,Wassim Boullif,es  ESP,"DF,MF",Espanyol,17-330,2005,0.8,2,1,2,0,0,2,2,100.0,0,3,2,1,0,2,1,0
57,Yassine Bounou,ma  MAR,GK,Sevilla,31-269,1991,11.5,1,1,1,0,0,1,3,33.3,2,0,0,0,1,2,7,0
58,Lucas Boyé,ar  ARG,FW,Elche,26-305,1996,8.9,10,5,2,6,2,7,11,63.6,4,12,2,10,8,18,13,0
59,Martin Braithwaite,dk  DEN,"FW,MF",Espanyol,31-208,1991,7.8,5,0,1,2,2,2,4,50.0,2,4,0,4,1,6,5,0
60,Juan Brandáriz,es  ESP,DF,Almería,23-303,1999,4.3,7,3,4,2,1,1,3,33.3,2,4,1,3,6,13,17,0
61,Darko Brašanac,rs  SRB,MF,Osasuna,30-321,1992,5.4,11,7,4,5,2,1,3,33.3,2,7,1,6,7,18,3,0
62,Claudio Bravo,cl  CHI,GK,Betis,39-261,1983,2.0,0,0,0,0,0,0,0,,0,0,0,0,1,1,0,0
63,Ante Budimir,hr  CRO,FW,Osasuna,31-161,1991,6.2,2,1,0,2,0,0,3,0.0,3,3,0,3,2,4,5,0
64,Santiago Bueno,uy  URU,DF,Girona,24-051,1998,15.0,26,14,14,12,0,12,14,85.7,2,17,13,4,20,46,33,0
65,Sergio Busquets,es  ESP,MF,Barcelona,34-167,1988,10.1,20,11,5,11,4,8,12,66.7,4,15,4,11,12,32,12,2
66,Leandro Cabrera,uy  URU,DF,Espanyol,31-196,1991,12.3,11,5,9,2,0,7,11,63.6,4,15,11,4,20,31,59,2
67,Cala,es  ESP,DF,Cádiz,33-034,1989,1.5,2,1,1,1,0,1,2,50.0,1,2,1,1,1,3,12,0
68,Fernando Calero,es  ESP,DF,Espanyol,27-107,1995,9.7,24,15,17,5,2,14,19,73.7,5,22,8,14,8,32,29,0
69,Eduardo Camavinga,fr  FRA,MF,Real Madrid,20-050,2002,5.7,16,13,6,8,2,2,7,28.6,5,8,2,6,3,19,2,0
70,Sergio Camello,es  ESP,FW,Rayo Vallecano,21-323,2001,11.4,8,5,2,4,2,2,6,33.3,4,4,0,4,0,8,7,0
71,Sergio Canales,es  ESP,"MF,FW",Betis,31-317,1991,10.4,8,5,5,2,1,5,9,55.6,4,5,0,5,2,10,4,0
72,Ander Capa,es  ESP,FW,Athletic Club,30-325,1992,0.0,0,0,0,0,0,0,0,,0,0,0,0,0,0,0,0
73,Étienne Capoue,fr  FRA,MF,Villarreal,34-172,1988,9.3,15,8,5,9,1,8,9,88.9,1,7,2,5,10,25,14,0
74,Isaac Carcelen,es  ESP,DF,Cádiz,29-251,1993,5.0,19,14,17,1,1,12,12,100.0,0,7,3,4,5,24,15,0
75,Juan Carlos,es  ESP,GK,Girona,34-344,1988,10.0,0,0,0,0,0,0,0,,0,0,0,0,1,1,7,1
76,Carmona,es  ESP,DF,Sevilla,20-335,2002,4.9,13,11,5,3,5,9,15,60.0,6,8,4,4,6,19,15,1
77,Yannick Carrasco,be  BEL,"DF,FW",Atlético Madrid,29-117,1993,8.8,16,10,8,8,0,12,22,54.5,10,7,1,6,4,20,7,0
78,Dani Carvajal,es  ESP,DF,Real Madrid,30-353,1992,9.7,18,9,8,7,3,11,17,64.7,6,13,3,10,11,29,23,0
79,William Carvalho,pt  POR,MF,Betis,30-267,1992,11.3,16,9,7,8,1,3,15,20.0,12,13,4,9,7,23,8,0
80,Casals,es  ESP,MF,Girona,17-206,2005,0.1,,0,,,,,,,,,,,0,,,
81,Casemiro,br  BRA,MF,Real Madrid,30-310,1992,0.1,0,0,0,0,0,0,0,,0,0,0,0,0,0,1,0
82,Valentín Castellanos,ar  ARG,FW,Girona,24-088,1998,13.2,6,3,1,2,3,0,7,0.0,7,11,2,9,4,10,9,0
83,Samu Castillejo,es  ESP,FW,Valencia,27-346,1995,6.8,8,2,2,4,2,3,11,27.3,8,12,2,10,3,11,0,0
84,Catena,es  ESP,DF,Rayo Vallecano,28-063,1994,14.0,6,2,4,2,0,4,8,50.0,4,11,9,2,7,13,61,1
85,Edinson Cavani,uy  URU,FW,Valencia,35-319,1987,4.8,2,0,1,0,1,0,5,0.0,5,5,2,3,0,2,2,0
86,Dani Ceballos,es  ESP,MF,Real Madrid,26-145,1996,2.0,7,4,2,1,4,4,10,40.0,6,4,0,4,5,12,1,0
87,Franco Cervi,ar  ARG,MF,Celta Vigo,28-218,1994,11.3,36,19,11,20,5,15,35,42.9,20,20,1,19,20,56,7,0
88,Pep Chavarría,es  ESP,"FW,DF",Rayo Vallecano,24-264,1998,0.7,0,0,0,0,0,0,1,0.0,1,1,0,1,0,0,5,0
89,Andreas Christensen,dk  DEN,DF,Barcelona,26-264,1996,3.5,4,2,2,2,0,1,1,100.0,0,1,0,1,3,7,9,0
90,Samuel Chukwueze,ng  NGA,"FW,MF",Villarreal,23-222,1999,6.0,6,2,1,1,4,3,5,60.0,2,4,0,4,2,8,8,0
91,Víctor Chust,es  ESP,DF,Cádiz,22-300,2000,9.5,8,6,7,1,0,3,6,50.0,3,7,3,4,10,18,44,0
92,Pathé Ciss,sn  SEN,"MF,DF",Rayo Vallecano,28-289,1994,8.1,25,21,7,14,4,9,20,45.0,11,12,8,4,13,38,23,0
93,Carlos Clerc,es  ESP,DF,Elche,30-312,1992,10.6,24,16,19,5,0,6,9,66.7,3,10,3,7,8,32,28,1
94,Álex Collado,es  ESP,MF,Elche,23-252,1999,6.0,22,11,11,9,2,7,11,63.6,4,10,1,9,2,24,3,0
95,Eray Cömert,ch  SUI,DF,Valencia,24-329,1998,9.7,12,7,9,3,0,8,13,61.5,5,13,6,7,12,24,29,1
96,Santi Comesaña,es  ESP,MF,Rayo Vallecano,26-086,1996,9.0,27,16,11,16,0,17,31,54.8,14,11,1,10,11,38,3,0
97,Copete,es  ESP,DF,Mallorca,23-081,1999,11.1,26,16,16,9,1,11,13,84.6,2,18,6,12,25,51,45,0
98,Francis Coquelin,fr  FRA,MF,Villarreal,31-231,1991,5.8,14,9,6,6,2,6,6,100.0,0,7,2,5,6,20,6,0
99,Jesús Corona,mx  MEX,FW,Sevilla,29-358,1993,0.7,1,0,1,0,0,0,0,,0,0,0,0,0,1,0,0
100,Ángel Correa,ar  ARG,"FW,MF",Atlético Madrid,27-296,1995,5.7,5,2,2,2,1,3,7,42.9,4,3,0,3,7,12,4,0
101,Thierry Correia,pt  POR,DF,Valencia,23-296,1999,13.5,32,22,19,12,1,17,26,65.4,9,13,1,12,16,48,32,2
102,Jaume Costa,es  ESP,DF,Mallorca,34-287,1988,10.7,18,11,9,6,3,12,18,66.7,6,6,2,4,4,22,15,0
103,Samu Costa,pt  POR,MF,Almería,22-033,2000,8.5,21,9,13,5,3,8,24,33.3,16,10,4,6,13,34,15,1
104,Thibaut Courtois,be  BEL,GK,Real Madrid,30-233,1992,10.0,0,0,0,0,0,0,0,,0,0,0,0,0,0,1,1
105,Yan Couto,br  BRA,"DF,MF",Girona,20-210,2002,6.4,15,10,8,5,2,7,12,58.3,5,5,2,3,3,18,2,0
106,Juan Cruz Armada,es  ESP,DF,Osasuna,30-155,1992,11.2,14,8,10,2,2,9,12,75.0,3,6,4,2,6,20,24,0
107,Juan Cruz,es  ESP,FW,Betis,22-249,2000,1.9,1,0,0,1,0,1,3,33.3,2,1,0,1,0,1,0,0
108,Jorge Cuenca,es  ESP,DF,Villarreal,23-043,1999,1.1,0,0,0,0,0,0,0,,0,0,0,0,0,0,9,0
109,Braian Cufré,ar  ARG,DF,Mallorca,26-015,1996,2.2,5,2,2,1,2,2,4,50.0,2,2,1,1,1,6,0,0
110,Matheus Cunha,br  BRA,"FW,MF",Atlético Madrid,23-217,1999,4.2,4,1,1,3,0,0,3,0.0,3,4,1,3,2,6,3,0
111,Curro,es  ESP,MF,Almería,26-361,1996,0.5,2,0,1,1,0,1,2,50.0,1,0,0,0,0,2,0,0
112,Sergi Darder,es  ESP,MF,Espanyol,29-008,1993,13.7,26,13,5,12,9,10,16,62.5,6,8,0,8,13,39,8,0
113,Rodrigo De Paul,ar  ARG,MF,Atlético Madrid,28-220,1994,7.4,8,1,1,7,0,4,7,57.1,3,11,2,9,2,10,2,0
114,Alberto Del Moral,es  ESP,MF,Villarreal,22-163,2000,0.1,0,0,0,0,0,0,0,,0,0,0,0,0,0,0,0
115,Thomas Delaney,dk  DEN,MF,Sevilla,31-118,1991,3.4,4,2,0,4,0,3,5,60.0,2,3,2,1,4,8,3,0
116,Fran Delgado,es  ESP,DF,Betis,21-172,2001,0.1,0,0,0,0,0,0,0,,0,0,0,0,0,0,0,0
117,Ousmane Dembélé,fr  FRA,FW,Barcelona,25-229,1997,9.6,14,9,4,6,4,2,10,20.0,8,7,0,7,0,14,2,0
118,Mouctar Diakhaby,gn  GUI,DF,Valencia,26-011,1996,8.8,14,8,9,5,0,6,8,75.0,2,10,6,4,7,21,31,1
119,Mamady Diarra,ml  MLI,"MF,DF",Cádiz,22-187,2000,0.7,2,1,2,0,0,1,2,50.0,1,2,0,2,0,2,0,0
120,Stole Dimitrievski,mk  MKD,GK,Rayo Vallecano,29-005,1993,14.0,0,0,0,0,0,0,0,,0,2,0,2,0,0,6,2
121,Malcom Abdulai Ares Djalo,es  ESP,FW,Athletic Club,21-079,2001,0.1,0,0,0,0,0,0,0,,0,0,0,0,0,0,0,0
122,Djené,tg  TOG,DF,Getafe,30-364,1991,11.1,9,5,8,1,0,5,8,62.5,3,4,4,0,12,21,25,1
123,Marko Dmitrović,rs  SRB,GK,Sevilla,30-340,1992,2.5,0,0,0,0,0,0,0,,0,0,0,0,0,0,2,0
124,Kasper Dolberg,dk  DEN,FW,Sevilla,25-085,1997,2.2,1,0,0,1,0,1,3,33.3,2,0,0,0,0,1,5,0
125,Carlos Dominguez,es  ESP,MF,Celta Vigo,21-322,2001,0.0,0,0,0,0,0,0,0,,0,0,0,0,0,0,0,0
126,John Donald,es  ESP,DF,Elche,22-122,2000,1.7,1,0,1,0,0,0,0,,0,2,2,0,5,6,3,1
127,Domingos Duarte,pt  POR,DF,Getafe,27-295,1995,12.5,12,7,10,2,0,10,12,83.3,2,15,13,2,18,30,65,0
128,Pablo Durán,es  ESP,"MF,DF",Celta Vigo,21-339,2001,0.3,0,0,0,0,0,0,0,,0,1,1,0,1,1,2,0
129,Hugo Duro,es  ESP,FW,Valencia,23-050,1999,4.3,5,2,1,1,3,4,5,80.0,1,1,0,1,0,5,3,1
130,Íñigo Eguaras,es  ESP,MF,Almería,30-298,1992,5.5,7,6,3,4,0,3,8,37.5,5,7,3,4,4,11,9,0
131,Aritz Elustondo,es  ESP,DF,Real Sociedad,28-277,1994,6.9,13,9,7,5,1,6,7,85.7,1,6,5,1,9,22,18,1
132,Rodrigo Ely,br  BRA,DF,Almería,29-057,1993,13.7,9,7,7,2,0,6,9,66.7,3,18,15,3,16,25,81,0
133,Youssef En-Nesyri,ma  MAR,"FW,MF",Sevilla,25-212,1997,4.0,3,2,0,3,0,1,3,33.3,2,1,1,0,1,4,3,0
134,Sergio Escudero,es  ESP,DF,Valladolid,33-119,1989,7.9,22,15,15,7,0,9,21,42.9,12,14,2,12,10,32,23,0
135,Alfonso Espino,uy  URU,DF,Cádiz,30-359,1992,12.7,33,23,22,7,4,20,41,48.8,21,25,5,20,12,45,29,0
136,Bernardo Espinosa,co  COL,DF,Girona,33-172,1989,5.5,4,0,1,3,0,2,3,66.7,1,7,3,4,3,7,20,2
137,Edu Expósito,es  ESP,MF,Espanyol,26-151,1996,8.6,24,15,9,13,2,9,14,64.3,5,5,0,5,9,33,13,0
138,Nicolás Ezequiel Fernández,ar  ARG,"MF,DF",Elche,22-353,2000,3.3,14,8,6,4,4,7,12,58.3,5,4,0,4,5,19,2,0
139,Abdessamad Ezzalzouli,ma  MAR,"MF,FW",Osasuna,21-013,2001,3.5,11,9,5,5,1,5,5,100.0,0,7,0,7,2,13,1,0
140,Radamel Falcao,co  COL,"FW,MF",Rayo Vallecano,36-323,1986,4.6,3,3,1,2,0,1,4,25.0,3,4,1,3,1,4,7,0
141,Fali,es  ESP,"DF,MF",Cádiz,29-140,1993,6.2,10,6,6,4,0,6,9,66.7,3,5,3,2,3,13,25,0
142,Ansu Fati,es  ESP,FW,Barcelona,20-060,2002,5.2,5,5,2,1,2,3,6,50.0,3,6,0,6,3,8,3,0
143,Zouhair Feddal,ma  MAR,DF,Valladolid,33-363,1989,3.9,4,2,1,3,0,3,4,75.0,1,9,9,0,4,8,25,0
144,Nabil Fekir,fr  FRA,"MF,FW",Betis,29-165,1993,5.7,5,1,2,1,2,1,4,25.0,3,4,0,4,0,5,0,0
145,Felipe,br  BRA,DF,Atlético Madrid,33-228,1989,2.0,3,2,1,2,0,2,4,50.0,2,2,2,0,0,3,7,0
146,Luiz Felipe,it  ITA,DF,Betis,25-283,1997,5.6,12,8,6,6,0,5,8,62.5,3,16,10,6,3,15,29,0
147,João Félix,pt  POR,"FW,MF",Atlético Madrid,23-050,1999,6.4,8,6,2,1,5,1,5,20.0,4,0,0,0,3,11,2,0
148,Kiko Femenía,es  ESP,DF,Villarreal,31-331,1991,9.4,6,3,4,1,1,4,7,57.1,3,11,5,6,14,20,17,0
149,Aitor Fernández,es  ESP,GK,Osasuna,31-241,1991,4.0,0,0,0,0,0,0,0,,0,0,0,0,0,0,2,0
150,Álex Fernández,es  ESP,"MF,FW",Cádiz,30-076,1992,7.8,5,2,3,1,1,2,5,40.0,3,7,1,6,4,9,8,0
151,Álvaro Fernández,es  ESP,GK,Espanyol,24-261,1998,4.0,0,0,0,0,0,0,0,,0,0,0,0,0,0,4,2
152,Carlos Fernández,es  ESP,FW,Real Sociedad,26-222,1996,2.6,2,2,0,2,0,0,5,0.0,5,1,0,1,1,3,2,0
153,Federico Fernández,ar  ARG,DF,Elche,33-312,1989,1.0,1,1,1,0,0,1,1,100.0,0,0,0,0,2,3,12,0
154,Joaquín Fernández,es  ESP,DF,Valladolid,26-213,1996,10.6,14,13,11,3,0,9,11,81.8,2,17,12,5,12,26,44,1
155,Fidel,es  ESP,"MF,FW",Elche,33-064,1989,1.9,1,1,1,0,0,0,3,0.0,3,2,0,2,1,2,0,0
156,Dimitri Foulquier,fr  FRA,"DF,MF",Valencia,29-282,1993,3.2,4,4,2,2,0,1,1,100.0,0,2,0,2,2,6,4,0
157,Juan Foyth,ar  ARG,DF,Villarreal,24-352,1998,2.8,6,4,3,3,0,5,7,71.4,2,3,0,3,4,10,12,0
158,Iván Fresneda,es  ESP,DF,Valladolid,18-093,2004,5.2,15,10,6,8,1,9,12,75.0,3,5,1,4,8,23,18,0
159,Javi Galán,es  ESP,DF,Celta Vigo,28-041,1994,13.9,44,29,27,15,2,16,35,45.7,19,20,1,19,8,52,14,0
160,Iñigo Ruiz de Galarreta,es  ESP,MF,Mallorca,29-146,1993,9.5,23,17,13,8,2,6,12,50.0,6,7,3,4,11,34,9,0
161,Aleix García,es  ESP,MF,Girona,25-185,1997,14.8,20,8,3,11,6,5,11,45.5,6,14,5,9,22,42,12,0
162,Álvaro García,es  ESP,FW,Rayo Vallecano,30-064,1992,13.2,20,9,9,4,7,4,7,57.1,3,17,1,16,8,28,10,0
163,Dani García,es  ESP,MF,Athletic Club,32-220,1990,4.9,11,8,4,6,1,8,11,72.7,3,3,0,3,4,15,7,0
164,David García,es  ESP,DF,Osasuna,28-319,1994,11.5,15,8,11,4,0,9,10,90.0,1,6,3,3,19,34,56,0
165,Eric García,es  ESP,DF,Barcelona,21-355,2001,6.8,12,7,8,2,2,4,6,66.7,2,12,6,6,9,21,9,1
166,Francisco Garcia,es  ESP,DF,Rayo Vallecano,23-138,1999,15.0,24,16,16,5,3,15,29,51.7,14,14,1,13,17,41,22,0
167,Raúl García,es  ESP,"MF,FW",Athletic Club,36-172,1986,4.2,7,5,2,1,4,3,5,60.0,2,4,1,3,1,8,5,0
168,Rubén García,es  ESP,MF,Osasuna,29-169,1993,4.7,7,1,5,1,1,3,8,37.5,5,5,0,5,4,11,6,0
169,Unai García,es  ESP,DF,Osasuna,30-330,1992,12.4,12,7,8,2,2,7,10,70.0,3,17,11,6,16,28,43,0
170,Felix Garreta,es  ESP,DF,Betis,18-253,2004,1.0,1,0,0,1,0,0,0,,0,1,1,0,1,2,4,0
171,Sékou Gassama,sn  SEN,FW,Valladolid,27-238,1995,0.4,0,0,0,0,0,0,0,,0,0,0,0,0,0,0,0
172,Gavi,es  ESP,MF,Barcelona,18-147,2004,8.9,14,11,2,8,4,6,11,54.5,5,9,1,8,9,23,5,0
173,Paulo Gazzaniga,ar  ARG,GK,Girona,30-362,1992,5.0,0,0,0,0,0,0,0,,0,0,0,0,0,0,3,0
174,Óscar Gil,es  ESP,DF,Espanyol,25-248,1997,9.6,23,13,12,7,4,8,13,61.5,5,10,3,7,9,32,15,0
175,Álvaro Giménez,es  ESP,FW,Cádiz,31-225,1991,0.2,0,0,0,0,0,0,1,0.0,1,0,0,0,0,0,0,0
176,Dani Gómez,es  ESP,"MF,FW",Espanyol,24-153,1998,0.7,2,1,1,1,0,1,1,100.0,0,0,0,0,1,3,0,0
177,Maxi Gómez,uy  URU,FW,Valencia,26-138,1996,1.2,0,0,0,0,0,0,0,,0,0,0,0,0,0,2,0
178,Moi Gómez,es  ESP,"MF,FW",Osasuna,28-190,1994,12.7,10,6,5,4,1,6,11,54.5,5,6,2,4,6,16,2,0
179,Papu Gómez,ar  ARG,"FW,MF",Sevilla,34-318,1988,7.2,5,4,2,3,0,1,3,33.3,2,4,1,3,4,9,5,0
180,Sergi Gómez,es  ESP,DF,Espanyol,30-277,1992,9.9,11,5,8,3,0,8,9,88.9,1,8,5,3,12,23,56,0
181,Diego González,es  ESP,DF,Elche,27-336,1995,4.6,6,5,3,3,0,3,5,60.0,2,5,5,0,3,9,21,0
182,Édgar González,es  ESP,DF,Betis,25-273,1997,9.4,13,11,10,3,0,9,13,69.2,4,7,7,0,10,23,54,0
183,Giovanni González,uy  URU,DF,Mallorca,28-101,1994,3.8,4,3,3,1,0,3,8,37.5,5,2,1,1,3,7,8,0
184,Nicolás González,es  ESP,MF,Valencia,20-361,2002,5.7,10,5,2,5,3,3,8,37.5,5,6,2,4,4,14,7,0
185,Roberto González,es  ESP,"FW,MF",Betis,21-358,2001,0.6,0,0,0,0,0,0,1,0.0,1,0,0,0,1,1,0,0
186,Andoni Gorosabel,es  ESP,DF,Real Sociedad,26-148,1996,7.9,19,7,11,3,5,12,16,75.0,4,6,0,6,7,26,6,0
187,Ivo Grbić,hr  CRO,GK,Atlético Madrid,26-346,1996,2.3,0,0,0,0,0,0,0,,0,0,0,0,0,0,3,0
188,Clément Grenier,fr  FRA,MF,Mallorca,31-357,1991,4.5,11,4,3,7,1,5,7,71.4,2,4,0,4,5,16,4,0
189,Antoine Griezmann,fr  FRA,"FW,MF",Atlético Madrid,31-284,1991,9.5,20,13,4,11,5,5,14,35.7,9,13,2,11,7,27,7,0
190,Arnaut Groeneveld,nl  NED,FW,Villarreal,25-333,1997,5.3,3,3,1,0,2,1,2,50.0,1,0,0,0,0,3,1,1
191,Andrés Guardado,mx  MEX,MF,Betis,36-093,1986,4.4,11,6,5,6,0,4,13,30.8,9,4,2,2,8,19,6,0
192,Sergi Guardiola,es  ESP,FW,Valladolid,31-215,1991,4.2,11,6,6,4,1,2,4,50.0,2,3,0,3,2,13,6,0
193,Nemanja Gudelj,rs  SRB,"DF,MF",Sevilla,31-044,1991,11.5,14,10,10,3,1,6,10,60.0,4,15,13,2,10,24,44,0
194,Ander Guevara,es  ESP,"MF,DF",Real Sociedad,25-176,1997,1.4,1,0,0,1,0,0,1,0.0,1,2,1,1,1,2,2,0
195,Hugo Guillamón,es  ESP,MF,Valencia,22-333,2000,10.2,9,4,4,5,0,2,12,16.7,10,8,1,7,10,19,9,2
196,Gerard Gumbau,es  ESP,MF,Elche,28-012,1994,9.2,12,7,4,7,1,3,10,30.0,7,11,5,6,6,18,14,0
197,Gorka Guruzeta,es  ESP,"FW,MF",Athletic Club,26-109,1996,3.0,2,2,2,0,0,1,3,33.3,2,2,0,2,2,4,1,0
198,Raúl Guti,es  ESP,MF,Elche,26-000,1996,8.1,14,8,6,7,1,7,15,46.7,8,7,2,5,7,21,3,0
199,Miguel Gutiérrez,es  ESP,DF,Girona,21-156,2001,11.1,14,7,9,4,1,5,8,62.5,3,10,1,9,6,20,17,1
200,Munir El Haddadi,ma  MAR,"MF,FW",Getafe,27-120,1995,2.6,2,1,1,0,1,1,2,50.0,1,4,0,4,1,3,0,0
201,Eden Hazard,be  BEL,FW,Real Madrid,31-357,1991,1.1,0,0,0,0,0,0,1,0.0,1,0,0,0,0,0,0,0
202,Luiz Henrique,br  BRA,FW,Betis,21-362,2001,9.2,27,19,13,11,3,8,21,38.1,13,10,0,10,7,34,4,0
203,Mario Hermoso,es  ESP,DF,Atlético Madrid,27-195,1995,1.9,0,0,0,0,0,0,1,0.0,1,4,2,2,3,3,7,0
204,Aridane Hernández,gq  EQG,DF,Osasuna,33-282,1989,1.6,1,1,1,0,0,0,1,0.0,1,2,2,0,3,4,7,0
205,Luis Hernández,es  ESP,DF,Cádiz,33-260,1989,12.0,8,5,5,2,1,6,9,66.7,3,13,12,1,11,19,54,0
206,Ander Herrera,es  ESP,MF,Athletic Club,33-138,1989,2.6,3,1,2,1,0,2,3,66.7,1,5,1,4,4,7,5,0
207,Sergio Herrera,es  ESP,GK,Osasuna,29-208,1993,10.0,0,0,0,0,0,0,0,,0,1,0,1,1,1,5,0
208,Yangel Herrera,ve  VEN,MF,Girona,24-357,1998,7.0,19,7,7,10,2,4,8,50.0,4,10,1,9,2,21,6,0
209,Omar El Hilali,ma  MAR,"DF,MF",Espanyol,19-109,2003,1.0,3,2,3,0,0,1,2,50.0,1,1,0,1,1,4,6,0
210,Pablo Ibáñez,es  ESP,MF,Osasuna,24-101,1998,0.4,1,0,1,0,0,0,0,,0,2,0,2,0,1,3,0
211,Iglesias,es  ESP,DF,Getafe,24-180,1998,11.4,34,18,23,8,3,17,31,54.8,14,18,5,13,8,42,36,0
212,Borja Iglesias,es  ESP,FW,Betis,29-347,1993,11.4,8,4,3,3,2,2,6,33.3,4,3,1,2,0,8,7,0
213,Asier Illarramendi,es  ESP,MF,Real Sociedad,32-297,1990,1.7,4,0,2,2,0,3,6,50.0,3,3,1,2,7,11,5,0
214,Alexander Isak,se  SWE,FW,Real Sociedad,23-100,1999,1.7,1,1,0,0,1,0,0,,0,0,0,0,0,1,2,0
215,Isco,es  ESP,"MF,FW",Sevilla,30-253,1992,8.9,15,9,6,5,4,8,14,57.1,6,3,0,3,10,25,3,0
216,Nicolas Jackson,sn  SEN,FW,Villarreal,21-193,2001,8.6,7,6,2,5,0,1,4,25.0,3,10,2,8,1,8,3,0
217,Adnan Januzaj,be  BEL,FW,Sevilla,27-328,1995,0.5,0,0,0,0,0,0,1,0.0,1,0,0,0,1,1,0,0
218,Javi,es  ESP,DF,Girona,24-242,1998,4.1,5,3,4,0,1,3,4,75.0,1,1,0,1,2,7,9,0
219,Joaquín,es  ESP,"MF,FW",Betis,41-162,1981,1.8,1,1,0,1,0,0,2,0.0,2,0,0,0,1,2,2,0
220,Frenkie de Jong,nl  NED,MF,Barcelona,25-232,1997,10.0,20,10,5,10,5,10,14,71.4,4,5,0,5,16,36,5,1
221,Joan Jordán,es  ESP,"MF,DF",Sevilla,28-177,1994,7.6,11,7,3,6,2,5,13,38.5,8,8,3,5,5,16,5,0
222,Josan,es  ESP,"DF,MF",Elche,33-027,1989,4.4,5,5,5,0,0,3,5,60.0,2,2,0,2,0,5,6,0
223,Willian José,br  BRA,FW,Betis,31-037,1991,3.3,5,3,4,1,0,2,5,40.0,3,2,0,2,0,5,5,0
224,Joselu,es  ESP,FW,Espanyol,32-278,1990,14.0,3,1,1,0,2,1,3,33.3,2,10,3,7,3,6,24,0
225,Juanmi,es  ESP,FW,Betis,29-224,1993,3.6,2,1,1,0,1,2,7,28.6,5,2,0,2,2,4,2,0
226,Juanpe,es  ESP,DF,Girona,31-244,1991,6.8,7,4,2,5,0,4,7,57.1,3,1,1,0,5,12,24,0
227,Lago Junior,ci  CIV,"FW,MF",Mallorca,31-364,1990,0.6,1,0,0,1,0,1,1,100.0,0,0,0,0,0,1,0,0
228,Vinicius Júnior,br  BRA,FW,Real Madrid,22-171,2000,13.6,17,11,7,6,4,8,19,42.1,11,9,0,9,5,22,1,0
229,Kaiky,br  BRA,DF,Almería,18-352,2004,5.4,5,5,5,0,0,3,6,50.0,3,17,10,7,11,16,20,0
230,Lee Kangin,kr  KOR,"MF,FW",Mallorca,21-314,2001,12.1,14,8,3,9,2,5,22,22.7,17,8,1,7,2,16,2,0
231,Jon Karrikaburu,es  ESP,FW,Real Sociedad,20-102,2002,1.0,1,0,0,1,0,0,0,,0,2,0,2,0,1,0,0
232,Kenedy,br  BRA,MF,Valladolid,26-325,1996,0.2,0,0,0,0,0,0,0,,0,0,0,0,0,0,0,0
233,Franck Kessié,ci  CIV,MF,Barcelona,26-011,1996,2.4,3,2,1,2,0,1,3,33.3,2,5,1,4,1,4,1,0
234,Kike,es  ESP,FW,Osasuna,33-035,1989,4.8,1,1,0,1,0,0,1,0.0,1,0,0,0,1,2,6,0
235,Justin Kluivert,nl  NED,"FW,MF",Valencia,23-239,1999,5.8,5,5,2,0,3,2,3,66.7,1,1,0,1,3,8,4,0
236,Koke,es  ESP,MF,Atlético Madrid,30-356,1992,8.4,20,14,9,9,2,8,18,44.4,10,8,4,4,1,21,9,0
237,Luca Koleosho,ca  CAN,"FW,DF",Espanyol,18-106,2004,0.3,0,0,0,0,0,0,1,0.0,1,1,0,1,0,0,0,0
238,Geoffrey Kondogbia,cf  CTA,MF,Atlético Madrid,29-318,1993,9.0,28,13,15,12,1,12,19,63.2,7,7,1,6,20,48,10,1
239,Jules Koundé,fr  FRA,DF,Barcelona,24-048,1998,6.4,7,5,3,3,1,3,3,100.0,0,4,2,2,4,11,5,0
240,Toni Kroos,de  GER,MF,Real Madrid,32-360,1990,9.5,20,12,4,16,0,9,22,40.9,13,14,2,12,8,28,5,0
241,Takefusa Kubo,jp  JPN,"FW,MF",Real Sociedad,21-209,2001,9.4,16,7,6,5,5,4,11,36.4,7,7,0,7,2,18,1,0
242,César de la Hoz,es  ESP,MF,Almería,30-275,1992,6.5,12,7,5,6,1,5,11,45.5,6,10,4,6,5,17,12,0
243,Luca de la Torre,us  USA,MF,Celta Vigo,24-221,1998,0.6,3,2,2,0,1,0,1,0.0,1,1,1,0,0,3,0,0
244,Érik Lamela,ar  ARG,"FW,MF",Sevilla,30-301,1992,10.6,19,12,5,6,8,5,15,33.3,10,11,1,10,2,21,0,0
245,Latasa,es  ESP,"FW,DF",Getafe,21-282,2001,0.7,1,1,0,0,1,0,0,,0,2,1,1,1,2,1,0
246,Toni Lato,es  ESP,"DF,MF",Valencia,25-039,1997,3.1,5,1,2,3,0,1,3,33.3,2,2,0,2,2,7,8,0
247,Lázaro,br  BRA,"MF,FW",Almería,20-293,2002,2.3,0,0,0,0,0,0,3,0.0,3,6,0,6,1,1,1,0
248,Robin Le Normand,fr  FRA,DF,Real Sociedad,26-049,1996,9.1,8,5,7,1,0,2,2,100.0,0,11,8,3,9,17,29,0
249,Benjamin Lecomte,fr  FRA,GK,Espanyol,31-248,1991,10.0,0,0,0,0,0,0,0,,0,0,0,0,0,0,3,2
250,Jeremías Ledesma,ar  ARG,GK,Cádiz,29-320,1993,14.0,0,0,0,0,0,0,1,0.0,1,1,0,1,2,2,9,1
251,Florian Lejeune,fr  FRA,DF,Rayo Vallecano,31-224,1991,11.5,9,5,6,2,1,6,11,54.5,5,9,7,2,6,15,48,0
252,Iñigo Lekue,es  ESP,DF,Athletic Club,29-240,1993,10.5,15,9,11,4,0,5,10,50.0,5,10,1,9,12,27,22,1
253,Thomas Lemar,fr  FRA,MF,Atlético Madrid,27-048,1995,4.6,9,4,3,4,2,2,7,28.6,5,3,2,1,3,12,3,0
254,Sergio León,es  ESP,FW,Valladolid,33-358,1989,6.9,2,2,0,1,1,1,1,100.0,0,4,0,4,0,2,3,0
255,Robert Lewandowski,pl  POL,FW,Barcelona,34-131,1988,11.8,7,4,0,2,5,4,8,50.0,4,7,0,7,0,7,2,0
256,Pol Lirola,es  ESP,DF,Elche,25-139,1997,6.1,12,6,8,3,1,7,10,70.0,3,1,0,1,6,18,12,0
257,Javier Llabrés,es  ESP,FW,Mallorca,20-110,2002,0.2,0,0,0,0,0,0,0,,0,0,0,0,0,0,1,0
258,Marcos Llorente,es  ESP,"DF,MF",Atlético Madrid,27-334,1995,8.4,19,10,12,5,2,13,16,81.3,3,9,0,9,8,27,10,0
259,Giovani Lo Celso,ar  ARG,"MF,FW",Villarreal,26-265,1996,5.8,21,17,3,13,5,8,12,66.7,4,6,0,6,5,26,3,0
260,David López,es  ESP,"DF,MF",Girona,33-082,1989,8.7,12,9,5,7,0,7,8,87.5,1,11,7,4,4,16,34,1
261,Diego López,es  ESP,GK,Rayo Vallecano,41-057,1981,1.0,0,0,0,0,0,0,0,,0,0,0,0,0,0,0,1
262,Unai López,es  ESP,MF,Rayo Vallecano,27-061,1995,6.5,9,4,3,4,2,5,13,38.5,8,4,1,3,8,17,3,1
263,Anthony Lozano,hn  HON,FW,Cádiz,29-249,1993,8.4,1,1,0,1,0,0,2,0.0,2,4,1,3,2,3,11,0
264,Pol Lozano,es  ESP,MF,Espanyol,23-085,1999,0.2,0,0,0,0,0,0,0,,0,1,0,1,0,0,1,0
265,José Luis Gayà,es  ESP,DF,Valencia,27-219,1995,9.6,24,13,19,3,2,14,22,63.6,8,12,5,7,11,35,19,0
266,José Luis Morales,es  ESP,FW,Villarreal,35-160,1987,4.7,3,2,1,0,2,3,5,60.0,2,6,1,5,0,3,0,0
267,Andriy Lunin,ua  UKR,GK,Real Madrid,23-322,1999,4.0,0,0,0,0,0,0,0,,0,0,0,0,0,0,0,0
268,Awer Mabil,au  AUS,"MF,FW",Cádiz,27-106,1995,1.8,2,0,0,1,1,1,3,33.3,2,1,1,0,0,2,1,0
269,Pablo Maffeo,es  ESP,DF,Mallorca,25-171,1997,11.3,17,15,12,4,1,10,20,50.0,10,13,7,6,10,27,24,0
270,Jon Magunacelaya,es  ESP,"MF,FW",Real Sociedad,22-170,2000,0.7,1,0,0,0,1,0,1,0.0,1,0,0,0,0,1,1,0
271,Nemanja Maksimović,rs  SRB,MF,Getafe,27-338,1995,7.9,13,4,5,6,2,5,9,55.6,4,17,9,8,10,23,8,0
272,Hugo Mallo,es  ESP,DF,Celta Vigo,31-191,1991,9.7,19,8,12,5,2,13,19,68.4,6,10,1,9,6,25,24,0
273,Mickael Malsa,mq  MTQ,MF,Valladolid,27-079,1995,0.4,1,1,1,0,0,0,3,0.0,3,1,1,0,1,2,2,0
274,Giorgi Mamardashvili,ge  GEO,GK,Valencia,22-092,2000,14.0,0,0,0,0,0,0,0,,0,0,0,0,0,0,8,1
275,Reinildo Mandava,mz  MOZ,DF,Atlético Madrid,28-343,1994,13.8,45,32,32,13,0,25,31,80.6,6,21,10,11,20,65,41,0
276,Aïssa Mandi,dz  ALG,DF,Villarreal,31-069,1991,2.9,4,3,3,1,0,1,1,100.0,0,3,3,0,7,11,8,0
277,Maranhão,br  BRA,"FW,MF",Valencia,26-071,1996,4.1,4,1,1,1,2,1,2,50.0,1,2,0,2,0,4,0,0
278,Marcão,br  BRA,DF,Sevilla,26-208,1996,4.0,2,2,1,1,0,1,1,100.0,0,3,3,0,5,7,13,0
279,Agustín Marchesín,ar  ARG,GK,Celta Vigo,34-289,1988,14.0,0,0,0,0,0,0,1,0.0,1,0,0,0,0,0,5,0
280,Óscar de Marcos,es  ESP,DF,Athletic Club,33-260,1989,13.0,21,11,8,10,3,11,22,50.0,11,16,4,12,7,28,18,0
281,José Mari,es  ESP,MF,Cádiz,35-024,1987,3.2,10,5,7,2,1,6,10,60.0,4,2,1,1,5,15,4,0
282,José María Giménez,uy  URU,DF,Atlético Madrid,27-344,1995,9.2,14,8,11,3,0,8,11,72.7,3,13,8,5,12,26,46,0
283,Mariano,do  DOM,FW,Real Madrid,29-151,1993,0.3,1,0,0,1,0,0,0,,0,0,0,0,0,1,0,0
284,Pablo Marín,es  ESP,"MF,FW",Real Sociedad,19-180,2003,1.2,1,1,0,1,0,0,0,,0,1,0,1,0,1,1,0
285,Roger Martí,es  ESP,"FW,MF",Elche,31-361,1991,5.5,5,2,3,2,0,1,4,25.0,3,4,0,4,1,6,6,0
286,Iván Martín,es  ESP,MF,Girona,23-319,1999,1.9,2,2,0,2,0,2,2,100.0,0,1,0,1,0,2,0,0
287,Arnau Martinez,es  ESP,"DF,MF",Girona,19-249,2003,10.0,17,10,13,2,2,11,21,52.4,10,11,2,9,8,25,12,0
288,Iñigo Martínez,es  ESP,DF,Athletic Club,31-227,1991,9.0,8,3,6,2,0,2,4,50.0,2,9,5,4,14,22,31,0
289,Omar Mascarell,es  ESP,MF,Elche,29-331,1993,12.3,19,10,9,8,2,9,24,37.5,15,16,5,11,15,34,19,1
290,Jordi Masip,es  ESP,GK,Valladolid,33-361,1989,9.0,0,0,0,0,0,0,0,,0,0,0,0,0,0,3,0
291,Jaime Mata,es  ESP,FW,Getafe,34-067,1988,0.5,0,0,0,0,0,0,0,,0,1,0,1,0,0,0,0
292,Borja Mayoral,es  ESP,FW,Getafe,25-269,1997,12.3,4,1,3,1,0,3,5,60.0,2,4,0,4,0,4,3,0
293,Mamadou Mbaye,sn  SEN,DF,Cádiz,24-185,1998,2.3,1,0,0,1,0,1,1,100.0,0,2,1,1,1,2,14,0
294,Gonzalo Melero,es  ESP,MF,Almería,28-362,1994,6.0,13,5,2,8,3,3,7,42.9,4,4,0,4,2,15,8,0
295,Memphis,nl  NED,FW,Barcelona,28-320,1994,1.3,2,1,1,1,0,0,0,,0,0,0,0,0,2,0,0
296,Houboulang Mendes,fr  FRA,DF,Almería,24-240,1998,5.5,9,6,8,1,0,4,12,33.3,8,7,1,6,3,12,16,0
297,Brais Méndez,es  ESP,MF,Real Sociedad,25-357,1997,12.5,31,18,9,16,6,15,27,55.6,12,13,1,12,5,36,6,0
298,Diego Méndez,es  ESP,MF,Rayo Vallecano,19-123,2003,0.0,0,0,0,0,0,0,0,,0,0,0,0,1,1,0,0
299,Ferland Mendy,fr  FRA,DF,Real Madrid,27-205,1995,9.8,12,6,9,3,0,7,13,53.8,6,5,2,3,10,22,9,0
300,Mikel Merino,es  ESP,MF,Real Sociedad,26-191,1996,12.5,33,19,12,17,4,15,25,60.0,10,15,5,10,13,46,32,0
301,Roque Mesa,es  ESP,MF,Valladolid,33-206,1989,9.6,18,7,13,5,0,8,23,34.8,15,9,0,9,7,25,13,0
302,Éder Militão,br  BRA,DF,Real Madrid,24-346,1998,10.1,18,10,11,6,1,11,12,91.7,1,22,13,9,12,30,33,1
303,Luis Milla,es  ESP,MF,Getafe,28-084,1994,7.2,19,12,11,6,2,11,18,61.1,7,3,0,3,9,28,8,1
304,Pere Milla,es  ESP,"FW,MF",Elche,30-098,1992,9.6,17,9,11,4,2,8,19,42.1,11,8,1,7,6,23,6,1
305,Marko Milovanović,rs  SRB,FW,Almería,19-148,2003,0.2,0,0,0,0,0,0,0,,0,0,0,0,0,0,0,0
306,Óscar Mingueza,es  ESP,DF,Celta Vigo,23-231,1999,5.3,19,9,15,3,1,13,14,92.9,1,5,3,2,4,23,11,0
307,Rafa Mir,es  ESP,FW,Sevilla,25-195,1997,6.2,5,1,2,2,1,1,2,50.0,1,1,0,1,2,7,7,0
308,Juan Miranda,es  ESP,DF,Betis,22-345,2000,1.0,4,3,3,1,0,2,2,100.0,0,0,0,0,1,5,2,0
309,Stefan Mitrović,rs  SRB,DF,Getafe,32-222,1990,11.5,5,3,4,1,0,2,5,40.0,3,6,6,0,10,15,64,2
310,Luka Modrić,hr  CRO,MF,Real Madrid,37-112,1985,10.3,12,4,4,5,3,6,12,50.0,6,8,4,4,4,16,2,0
311,Nahuel Molina,ar  ARG,DF,Atlético Madrid,24-268,1998,10.3,20,13,9,9,2,11,19,57.9,8,12,1,11,5,25,17,1
312,Jon Moncayola,es  ESP,MF,Osasuna,24-231,1998,9.7,15,7,8,6,1,7,16,43.8,9,10,1,9,1,16,9,0
313,Monchu,es  ESP,MF,Valladolid,23-108,1999,7.3,23,13,8,11,4,9,16,56.3,7,12,7,5,7,30,7,1
314,Gonzalo Montiel,ar  ARG,DF,Sevilla,25-363,1997,6.5,8,3,4,4,0,6,9,66.7,3,9,4,5,7,15,8,0
315,Martín Montoya,es  ESP,DF,Betis,31-260,1991,2.0,7,5,5,2,0,6,6,100.0,0,2,0,2,2,9,5,0
316,Álvaro Morata,es  ESP,FW,Atlético Madrid,30-068,1992,10.4,10,7,4,4,2,2,5,40.0,3,5,3,2,0,10,12,0
317,Jon Morcillo,es  ESP,"FW,MF",Athletic Club,24-106,1998,0.6,0,0,0,0,0,0,1,0.0,1,0,0,0,1,1,0,0
318,Alberto Moreno,es  ESP,"DF,FW",Villarreal,30-178,1992,4.1,7,2,1,5,1,4,12,33.3,8,5,1,4,7,14,7,0
319,Álex Moreno,es  ESP,DF,Betis,29-205,1993,14.0,24,17,18,6,0,16,33,48.5,17,17,4,13,16,40,36,0
320,Gerard Moreno,es  ESP,FW,Villarreal,30-267,1992,4.2,4,3,0,3,1,1,2,50.0,1,3,1,2,1,5,2,0
321,Tete Morente,es  ESP,"MF,DF",Elche,26-026,1996,8.1,9,4,5,3,1,4,9,44.4,5,9,1,8,4,13,9,0
322,Ilaix Moriba,gn  GUI,MF,Valencia,19-345,2003,3.7,8,5,2,3,3,4,5,80.0,1,3,0,3,2,10,6,0
323,Manu Morlanes,es  ESP,MF,Villarreal,23-352,1999,1.6,3,2,2,1,0,3,3,100.0,0,2,1,1,1,4,2,0
324,Loren Morón,es  ESP,FW,Betis,29-000,1993,0.2,2,2,0,1,1,0,0,,0,0,0,0,0,2,1,0
325,Cristhian Mosquera,co  COL,DF,Valencia,18-186,2004,0.6,1,1,1,0,0,1,1,100.0,0,0,0,0,1,2,3,0
326,Abdul Mumin,gh  GHA,DF,Rayo Vallecano,24-207,1998,2.1,0,0,0,0,0,0,0,,0,2,2,0,1,1,4,0
327,Iker Muniain,es  ESP,"MF,FW",Athletic Club,30-011,1992,9.0,7,5,1,5,1,2,4,50.0,2,2,0,2,3,10,1,0
328,Aihen Muñoz,es  ESP,DF,Real Sociedad,25-136,1997,7.4,17,9,10,5,2,10,17,58.8,7,12,3,9,3,20,10,0
329,Pablo Muñoz,es  ESP,MF,Rayo Vallecano,19-117,2003,0.1,0,0,0,0,0,0,1,0.0,1,0,0,0,0,0,0,0
330,Vedat Muriqi,xk  KVX,FW,Mallorca,28-250,1994,11.5,6,4,3,3,0,2,4,50.0,2,5,2,3,3,9,19,0
331,Yunus Musah,us  USA,MF,Valencia,20-031,2002,9.4,21,14,7,12,2,5,8,62.5,3,4,0,4,5,26,9,2
332,Nacho,es  ESP,DF,Real Madrid,32-346,1990,1.6,1,1,0,1,0,0,0,,0,2,2,0,3,4,1,0
333,Juanjo Narváez,co  COL,"MF,FW",Valladolid,27-321,1995,1.6,1,1,1,0,0,1,1,100.0,0,2,0,2,0,1,0,0
334,Matija Nastasić,rs  SRB,DF,Mallorca,29-277,1993,3.2,4,3,2,1,1,0,2,0.0,2,1,0,1,8,12,19,0
335,Roberto Navarro,es  ESP,"MF,DF",Real Sociedad,20-262,2002,1.7,3,2,3,0,0,0,1,0.0,1,4,0,4,0,3,1,0
336,Jesús Navas,es  ESP,"DF,FW",Sevilla,37-039,1985,7.0,7,4,2,1,4,3,10,30.0,7,6,3,3,3,10,12,0
337,Álvaro Negredo,es  ESP,FW,Cádiz,37-132,1985,4.6,4,4,1,1,2,1,1,100.0,0,4,1,3,0,4,5,0
338,Tanguy Nianzou,fr  FRA,DF,Sevilla,20-206,2002,7.1,10,9,6,4,0,6,6,100.0,0,6,4,2,8,18,18,0
339,Saúl Ñíguez,es  ESP,"MF,DF",Atlético Madrid,28-039,1994,5.3,25,15,9,12,4,12,20,60.0,8,12,1,11,8,33,12,0
340,Diego Noguerol,es  ESP,"FW,DF",Valencia,20-231,2002,0.1,0,0,0,0,0,0,0,,0,0,0,0,0,0,0,0
341,Randy Ntekja,fr  FRA,"FW,MF",Rayo Vallecano,25-024,1997,0.7,2,2,2,0,0,1,1,100.0,0,0,0,0,1,3,3,0
342,Unai Núñez,es  ESP,DF,Celta Vigo,25-334,1997,13.0,10,7,4,5,1,2,9,22.2,7,7,5,2,23,33,49,1
343,Jan Oblak,si  SVN,GK,Atlético Madrid,29-357,1993,12.7,0,0,0,0,0,0,0,,0,0,0,0,0,0,4,0
344,Brian Ocampo,uy  URU,"MF,FW",Cádiz,23-188,1999,6.2,8,7,4,3,1,6,10,60.0,4,5,0,5,1,9,3,0
345,Lucas Ocampos,ar  ARG,"FW,MF",Sevilla,28-172,1994,1.5,3,1,0,2,1,1,3,33.3,2,1,0,1,1,4,1,0
346,Lucas Olaza,uy  URU,DF,Valladolid,28-162,1994,7.1,13,9,8,4,1,9,11,81.8,2,10,2,8,7,20,14,0
347,Brian Oliván,es  ESP,DF,Espanyol,28-273,1994,13.4,31,18,20,7,4,10,13,76.9,3,8,2,6,14,45,33,0
348,Lucas Oliveira Rosa,br  BRA,DF,Valladolid,22-271,2000,3.6,16,6,11,3,2,6,9,66.7,3,6,1,5,7,23,7,0
349,Aimar Oroz,es  ESP,"MF,FW",Osasuna,21-033,2001,8.6,9,5,2,2,5,0,3,0.0,3,9,0,9,11,20,5,0
350,Cenk Özkacar,tr  TUR,DF,Valencia,22-085,2000,2.7,4,3,2,2,0,1,1,100.0,0,2,0,2,1,5,6,0
351,Fernando Pacheco,es  ESP,GK,Almería,30-226,1992,1.0,0,0,0,0,0,0,0,,0,0,0,0,0,0,1,0
352,Jon Pacheco,es  ESP,DF,Real Sociedad,21-356,2001,7.5,9,7,6,3,0,2,4,50.0,2,3,3,0,6,15,20,0
353,Gonçalo Paciência,pt  POR,"FW,MF",Celta Vigo,28-151,1994,3.7,5,3,0,4,1,1,3,33.3,2,4,1,3,0,5,2,0
354,Helibelton Palacios,co  COL,DF,Elche,29-202,1993,8.7,13,8,8,4,1,6,9,66.7,3,8,3,5,9,22,23,0
355,Isaac Palazón Camacho,es  ESP,"FW,MF",Rayo Vallecano,28-003,1994,12.0,22,17,6,12,4,11,22,50.0,11,8,0,8,4,26,8,0
356,Aitor Paredes,es  ESP,DF,Athletic Club,22-245,2000,0.3,2,1,2,0,0,2,3,66.7,1,0,0,0,2,4,0,0
357,Daniel Parejo,es  ESP,MF,Villarreal,33-258,1989,13.6,24,13,10,8,6,8,26,30.8,18,15,6,9,10,34,13,1
358,Moises Parra Gutierrez,es  ESP,FW,Getafe,20-189,2002,0.1,1,0,0,1,0,0,0,,0,0,0,0,0,1,0,0
359,Javier Pastore,ar  ARG,MF,Elche,33-193,1989,0.1,0,0,0,0,0,0,0,,0,0,0,0,0,0,0,0
360,Gabriel Paulista,br  BRA,DF,Valencia,32-034,1990,6.4,9,5,7,2,0,7,11,63.6,4,8,5,3,8,17,28,0
361,Alfonso Pedraza,es  ESP,DF,Villarreal,26-265,1996,8.9,17,16,8,7,2,11,14,78.6,3,7,1,6,5,22,14,0
362,Pedri,es  ESP,MF,Barcelona,20-035,2002,11.4,20,11,7,11,2,9,29,31.0,20,17,0,17,9,29,7,0
363,Rubén Peña,es  ESP,"DF,MF",Osasuna,31-165,1991,6.3,11,5,2,9,0,8,15,53.3,7,6,3,3,8,19,14,0
364,Alberto Perea,es  ESP,MF,Cádiz,32-011,1990,0.5,2,0,2,0,0,0,0,,0,2,0,2,0,2,0,0
365,Carles Pérez,es  ESP,"FW,MF",Celta Vigo,24-317,1998,6.7,13,8,4,6,3,6,12,50.0,6,10,2,8,1,14,4,0
366,Francisco Perez,es  ESP,"FW,DF",Valencia,20-112,2002,0.2,0,0,0,0,0,0,0,,0,0,0,0,0,0,0,0
367,Kike Pérez,es  ESP,MF,Valladolid,25-319,1997,10.7,23,7,12,9,2,7,24,29.2,17,9,2,7,8,31,10,0
368,Lucas Pérez,es  ESP,FW,Cádiz,34-111,1988,6.6,3,2,2,1,0,1,3,33.3,2,2,0,2,1,4,3,0
369,Luis Pérez,es  ESP,DF,Valladolid,27-329,1995,4.3,15,8,8,4,3,8,11,72.7,3,5,3,2,5,20,7,0
370,Germán Pezzella,ar  ARG,DF,Betis,31-186,1991,10.1,17,11,13,4,0,10,12,83.3,2,12,5,7,22,39,40,1
371,Yeremi Pino,es  ESP,"MF,FW",Villarreal,20-071,2002,7.7,19,13,11,6,2,8,19,42.1,11,8,1,7,6,25,15,0
372,Gerard Piqué,es  ESP,DF,Barcelona,35-331,1987,4.3,5,4,1,4,0,4,4,100.0,0,2,1,1,2,7,19,0
373,Óscar Plano,es  ESP,"FW,MF",Valladolid,31-322,1991,9.2,16,10,4,5,7,4,8,50.0,4,9,1,8,12,28,9,0
374,Gonzalo Plata,ec  ECU,"FW,MF",Valladolid,22-059,2000,6.6,12,8,6,4,2,4,10,40.0,6,5,0,5,4,16,2,0
375,Ezequiel Ponce,ar  ARG,FW,Elche,25-276,1997,5.9,5,4,0,3,2,0,2,0.0,2,4,1,3,0,5,9,0
376,Francisco Portillo,es  ESP,"MF,FW",Almería,32-200,1990,2.2,3,2,1,1,1,0,3,0.0,3,1,1,0,2,5,2,0
377,Portu,es  ESP,"MF,DF",Getafe,30-223,1992,4.3,7,4,2,5,0,5,9,55.6,4,6,0,6,2,9,3,0
378,José Pozo,es  ESP,MF,Rayo Vallecano,26-290,1996,0.8,1,1,0,1,0,0,0,,0,0,0,0,1,2,1,0
379,Alejandro Pozo Pozo,es  ESP,DF,Almería,23-311,1999,6.4,9,5,4,4,1,7,12,58.3,5,9,4,5,11,20,13,1
380,Abdón Prats,es  ESP,"FW,MF",Mallorca,30-023,1992,1.5,1,0,1,0,0,0,0,,0,1,0,1,0,1,2,0
381,Javi Puado,es  ESP,"FW,MF",Espanyol,24-219,1998,8.3,6,2,3,2,1,3,9,33.3,6,2,0,2,3,9,4,0
382,Arnau Puigmal,es  ESP,"MF,DF",Almería,21-354,2001,2.7,2,1,0,1,1,1,2,50.0,1,3,0,3,3,5,1,0
383,Domingos Quina,pt  POR,MF,Elche,23-042,1999,3.1,3,2,2,1,0,1,3,33.3,2,5,0,5,3,6,1,0
384,Antonio Raillo,es  ESP,DF,Mallorca,31-083,1991,13.0,10,5,10,0,0,2,5,40.0,3,11,7,4,15,25,65,0
385,Predrag Rajković,rs  SRB,GK,Mallorca,27-060,1995,14.0,0,0,0,0,0,0,1,0.0,1,0,0,0,0,0,5,0
386,Ivan Rakitić,hr  CRO,MF,Sevilla,34-295,1988,5.8,10,7,3,4,3,6,13,46.2,7,6,0,6,9,19,9,0
387,Largie Ramazani,be  BEL,FW,Almería,21-306,2001,8.9,7,5,3,0,4,5,12,41.7,7,6,0,6,5,12,1,0
388,Raphinha,br  BRA,FW,Barcelona,26-016,1996,6.3,9,7,2,1,6,5,10,50.0,5,14,1,13,5,14,2,0
389,Sergio Reguilón,es  ESP,DF,Atlético Madrid,26-014,1996,0.6,3,2,2,1,0,2,3,66.7,1,1,0,1,1,4,0,0
390,Reinier,br  BRA,"MF,FW",Girona,20-345,2002,3.5,6,4,4,0,2,1,4,25.0,3,3,0,3,1,7,2,0
391,Karim Rekik,nl  NED,DF,Sevilla,28-028,1994,4.7,1,0,1,0,0,1,2,50.0,1,3,0,3,6,7,9,0
392,Álex Remiro,es  ESP,GK,Real Sociedad,27-281,1995,14.0,0,0,0,0,0,0,0,,0,0,0,0,0,0,8,2
393,Alejandro Revuelta Montero,es  ESP,DF,Getafe,22-258,2000,0.0,0,0,0,0,0,0,0,,0,0,0,0,0,0,1,0
394,Chadi Riad,es  ESP,MF,Barcelona,19-196,2003,0.0,0,0,0,0,0,0,0,,0,0,0,0,0,0,0,0
395,Nico Ribaudo,es  ESP,"FW,MF",Espanyol,21-263,2001,2.0,4,3,1,2,1,2,4,50.0,2,2,0,2,1,5,1,0
396,Diego Rico,es  ESP,DF,Real Sociedad,29-310,1993,6.6,14,11,4,6,4,4,7,57.1,3,2,0,2,5,19,16,0
397,Rodrigo Riquelme,es  ESP,"MF,FW",Girona,22-272,2000,9.6,8,0,4,2,2,3,12,25.0,9,5,0,5,3,11,1,0
398,Sergi Roberto,es  ESP,DF,Barcelona,30-326,1992,4.2,5,5,3,1,1,3,4,75.0,1,2,1,1,7,12,7,0
399,Lucas Robertone,ar  ARG,MF,Almería,25-287,1997,11.3,15,8,6,7,2,6,19,31.6,13,22,3,19,16,31,14,0
400,Enzo Roco,cl  CHI,DF,Elche,30-136,1992,8.8,11,6,9,2,0,6,10,60.0,4,7,5,2,6,17,22,1
401,Rodrigo,es  ESP,FW,Betis,22-228,2000,7.7,5,4,1,3,1,3,5,60.0,2,4,0,4,6,11,0,0
402,Ángel Rodríguez,es  ESP,"FW,MF",Mallorca,35-248,1987,1.7,0,0,0,0,0,0,0,,0,0,0,0,0,0,1,0
403,Óscar Rodríguez Arnaiz,es  ESP,MF,Celta Vigo,24-185,1998,11.1,19,16,7,9,3,7,12,58.3,5,5,1,4,13,32,7,0
404,Dani Rodríguez,es  ESP,MF,Mallorca,34-207,1988,7.7,15,6,8,6,1,6,13,46.2,7,8,2,6,10,25,7,0
405,Guido Rodríguez,ar  ARG,MF,Betis,28-262,1994,11.6,38,25,15,19,4,17,28,60.7,11,19,6,13,13,51,24,0
406,Rodrygo,br  BRA,FW,Real Madrid,21-355,2001,10.1,9,4,1,5,3,1,4,25.0,3,9,0,9,3,12,3,0
407,Iván Romero,es  ESP,MF,Sevilla,21-264,2001,0.1,0,0,0,0,0,0,0,,0,0,0,0,0,0,0,0
408,Oriol Romeu,es  ESP,MF,Girona,31-097,1991,12.0,36,19,20,12,4,12,22,54.5,10,15,4,11,16,52,12,0
409,Rubén,es  ESP,"MF,FW",Espanyol,21-329,2001,2.7,9,6,4,3,2,8,8,100.0,0,3,1,2,7,16,3,0
410,Antonio Rüdiger,de  GER,DF,Real Madrid,29-302,1993,7.6,3,3,2,1,0,2,3,66.7,1,5,3,2,4,7,24,0
411,Aitor Ruibal,es  ESP,"DF,FW",Betis,26-283,1996,6.3,18,9,16,1,1,11,19,57.9,8,4,0,4,13,31,14,0
412,Víctor Ruiz,es  ESP,DF,Betis,33-339,1989,3.8,1,0,1,0,0,0,0,,0,6,3,3,3,4,18,0
413,Gerónimo Rulli,ar  ARG,GK,Villarreal,30-224,1992,14.0,0,0,0,0,0,0,0,,0,1,0,1,1,1,6,2
414,Franco Russo,ar  ARG,DF,Mallorca,28-066,1994,0.9,1,1,1,0,0,0,1,0.0,1,4,0,4,2,3,4,0
415,Youssouf Sabaly,sn  SEN,DF,Betis,29-300,1993,7.9,15,6,12,3,0,8,9,88.9,1,16,5,11,8,23,18,1
416,Samuel Sáiz,es  ESP,"MF,FW",Girona,31-342,1991,2.4,2,2,0,2,0,1,2,50.0,1,3,0,3,0,2,1,1
417,Salvi,es  ESP,"FW,MF",Rayo Vallecano,31-275,1991,2.9,7,5,2,3,2,1,3,33.3,2,0,0,0,2,9,0,0
418,Samuel,br  BRA,"FW,MF",Valencia,23-007,1999,13.5,23,16,7,14,2,6,15,40.0,9,12,0,12,4,27,2,0
419,Fede San Emeterio,es  ESP,MF,Cádiz,25-289,1997,8.8,9,4,5,2,2,3,12,25.0,9,17,7,10,3,12,7,0
420,Oihan Sancet,es  ESP,MF,Athletic Club,22-249,2000,11.2,9,4,1,5,3,4,16,25.0,12,5,0,5,3,12,3,0
421,Antonio Sánchez,es  ESP,MF,Mallorca,25-363,1997,6.4,6,3,4,1,1,3,13,23.1,10,7,0,7,8,14,3,0
422,Iván Sánchez,es  ESP,"FW,MF",Valladolid,30-098,1992,6.2,7,5,3,1,3,5,12,41.7,7,6,0,6,1,8,0,0
423,Javi Sánchez,es  ESP,DF,Valladolid,25-291,1997,11.1,14,8,9,5,0,4,7,57.1,3,15,12,3,18,32,53,0
424,Manuel Sánchez,es  ESP,DF,Osasuna,22-128,2000,5.2,15,11,11,4,0,10,14,71.4,4,10,1,9,5,20,11,0
425,Esteban Saveljich,me  MNE,FW,Rayo Vallecano,31-224,1991,0.0,0,0,0,0,0,0,0,,0,0,0,0,0,0,0,0
426,Stefan Savić,me  MNE,DF,Atlético Madrid,31-356,1991,10.8,18,14,15,3,0,14,16,87.5,2,5,2,3,19,37,32,0
427,Jaime Seoane,es  ESP,MF,Getafe,25-342,1997,3.0,10,4,3,4,3,2,6,33.3,4,3,2,1,1,11,2,0
428,David Silva,es  ESP,MF,Real Sociedad,36-356,1986,9.1,12,6,4,7,1,2,5,40.0,3,3,0,3,5,17,7,0
429,Rui Silva,pt  POR,GK,Betis,28-326,1994,13.0,2,1,2,0,0,2,2,100.0,0,0,0,0,0,2,7,1
430,Unai Simón,es  ESP,GK,Athletic Club,25-202,1997,15.0,0,0,0,0,0,0,0,,0,1,0,1,0,0,7,1
431,Rubén Sobrino,es  ESP,"MF,FW",Cádiz,30-212,1992,8.9,11,5,3,5,3,2,4,50.0,2,7,0,7,6,17,11,0
432,Alex Sola,es  ESP,DF,Real Sociedad,23-204,1999,3.1,16,8,12,3,1,7,10,70.0,3,5,0,5,3,19,10,0
433,Augusto Solari,ar  ARG,"MF,FW",Celta Vigo,30-361,1992,2.1,5,5,2,2,1,1,6,16.7,5,4,0,4,3,8,0,0
434,Carlos Soler,es  ESP,MF,Valencia,25-362,1997,2.7,2,0,0,1,1,2,3,66.7,1,1,0,1,0,2,2,0
435,David Soria,es  ESP,GK,Getafe,29-270,1993,14.0,0,0,0,0,0,0,0,,0,0,0,0,0,0,6,3
436,Dyego Sousa,pt  POR,FW,Almería,33-107,1989,3.4,4,2,2,1,1,2,2,100.0,0,3,1,2,0,4,8,0
437,Vinicius Souza,br  BRA,MF,Espanyol,23-196,1999,13.2,53,34,21,23,9,16,26,61.5,10,14,9,5,29,82,27,1
438,Jørgen Strand Larsen,no  NOR,FW,Celta Vigo,22-327,2000,7.7,3,1,1,1,1,1,8,12.5,7,5,2,3,1,4,11,0
439,Cristhian Stuani,uy  URU,FW,Girona,36-079,1986,4.8,4,1,1,1,2,3,5,60.0,2,1,0,1,1,5,4,0
440,Damián Suárez,uy  URU,DF,Getafe,34-247,1988,6.1,10,7,3,4,3,4,8,50.0,4,9,0,9,5,15,14,0
441,Mario Suárez,es  ESP,"DF,MF",Rayo Vallecano,35-309,1987,0.1,0,0,0,0,0,0,0,,0,1,0,1,0,0,0,0
442,Suso,es  ESP,"FW,MF",Sevilla,29-041,1993,1.0,2,2,1,1,0,1,2,50.0,1,1,0,1,0,2,0,0
443,Williot Swedberg,se  SWE,MF,Celta Vigo,18-332,2004,0.4,1,0,0,0,1,0,0,,0,0,0,0,0,1,0,0
444,Alexander Sørloth,no  NOR,FW,Real Sociedad,27-025,1995,9.1,3,3,0,1,2,1,4,25.0,3,4,1,3,0,3,9,1
445,Renato Tapia,pe  PER,MF,Celta Vigo,27-155,1995,7.1,18,10,9,8,1,4,11,36.4,7,14,8,6,8,26,11,0
446,Aurélien Tchouaméni,fr  FRA,MF,Real Madrid,22-337,2000,10.0,27,15,8,19,0,10,16,62.5,6,10,2,8,21,48,21,0
447,Alex Telles,br  BRA,DF,Sevilla,30-015,1992,8.4,9,5,6,3,0,7,12,58.3,5,6,1,5,7,16,9,0
448,Marc-André ter Stegen,de  GER,GK,Barcelona,30-244,1992,14.0,0,0,0,0,0,0,0,,0,0,0,0,1,1,3,2
449,Ramón Terrats,es  ESP,MF,Girona,22-073,2000,1.6,2,1,0,2,0,1,4,25.0,3,3,1,2,2,4,1,1
450,Pablo Torre,es  ESP,FW,Barcelona,19-271,2003,0.2,0,0,0,0,0,0,0,,0,0,0,0,0,0,0,0
451,Ferrán Torres,es  ESP,"FW,MF",Barcelona,22-304,2000,6.3,5,2,0,4,1,2,8,25.0,6,5,1,4,1,6,2,0
452,Óliver Torres,es  ESP,"MF,FW",Sevilla,28-050,1994,9.4,15,9,3,6,6,8,19,42.1,11,13,2,11,7,22,3,0
453,Pau Torres,es  ESP,DF,Villarreal,25-348,1997,13.0,9,5,4,4,1,6,8,75.0,2,11,10,1,3,12,53,2
454,Roberto Torres,es  ESP,"FW,MF",Osasuna,33-298,1989,0.1,0,0,0,0,0,0,0,,0,0,0,0,0,0,0,0
455,Lucas Torró,es  ESP,MF,Osasuna,28-164,1994,12.5,20,13,7,10,3,7,11,63.6,4,7,1,6,13,33,23,0
456,Nabil Touaizi,ma  MAR,MF,Espanyol,21-332,2001,0.0,0,0,0,0,0,0,0,,0,0,0,0,0,0,0,0
457,Óscar Trejo,ar  ARG,"MF,FW",Rayo Vallecano,34-248,1988,10.0,16,14,3,7,6,3,8,37.5,5,11,2,9,5,21,3,0
458,Manu Trigueros,es  ESP,"MF,FW",Villarreal,31-074,1991,2.8,4,2,2,2,0,2,7,28.6,5,2,1,1,1,5,2,0
459,Beñat Turrientes,es  ESP,"MF,FW",Real Sociedad,20-333,2002,1.2,4,3,4,0,0,1,4,25.0,3,2,0,2,0,4,3,0
460,Enes Ünal,tr  TUR,FW,Getafe,25-234,1997,13.5,12,6,4,7,1,4,10,40.0,6,6,1,5,0,12,19,0
461,Oscar Ureña,es  ESP,MF,Girona,19-363,2003,1.1,4,2,2,2,0,2,3,66.7,1,2,0,2,1,5,0,0
462,Óscar Valentín,es  ESP,MF,Rayo Vallecano,28-132,1994,10.6,43,22,12,23,8,21,37,56.8,16,25,5,20,19,62,12,0
463,Valery,es  ESP,"MF,DF",Girona,23-037,1999,4.6,6,3,1,5,0,2,3,66.7,1,4,0,4,2,8,2,0
464,Enrique Valiente,es  ESP,DF,Sevilla,20-251,2002,3.1,0,0,0,0,0,0,0,,0,3,2,1,1,1,19,0
465,Martin Valjent,sk  SVK,DF,Mallorca,27-019,1995,12.8,14,9,11,3,0,8,11,72.7,3,23,10,13,17,31,51,0
466,Manu Vallejo,es  ESP,"FW,MF",Girona,25-319,1997,2.3,4,1,1,2,1,1,6,16.7,5,2,0,2,1,5,3,0
467,Federico Valverde,uy  URU,"FW,MF",Real Madrid,24-161,1998,12.3,12,8,4,5,3,5,13,38.5,8,11,1,10,5,17,4,0
468,Jesus Vazquez,es  ESP,"DF,MF",Valencia,19-362,2003,1.6,4,4,2,0,2,0,1,0.0,1,2,0,2,0,4,3,0
469,Kevin Vázquez,es  ESP,MF,Celta Vigo,29-282,1993,0.8,2,1,0,1,1,0,0,,0,1,0,1,0,2,1,0
470,Lucas Vázquez,es  ESP,DF,Real Madrid,31-182,1991,4.1,11,7,4,6,1,5,5,100.0,0,4,0,4,4,15,3,0
471,Gabriel Veiga,es  ESP,MF,Celta Vigo,20-217,2002,6.4,18,7,5,13,0,7,16,43.8,9,7,0,7,5,23,3,0
472,Unai Vencedor Paris,es  ESP,MF,Athletic Club,22-045,2000,1.6,3,1,0,3,0,1,5,20.0,4,3,0,3,1,4,0,0
473,Gonzalo Verdú,es  ESP,DF,Elche,34-070,1988,4.8,4,1,4,0,0,2,5,40.0,3,7,6,1,5,9,21,0
474,Mikel Vesga,es  ESP,MF,Athletic Club,29-223,1993,11.3,27,16,10,13,4,12,38,31.6,26,14,3,11,18,45,13,1
475,Aleix Vidal,es  ESP,"FW,MF",Espanyol,33-131,1989,5.0,4,2,2,1,1,0,7,0.0,7,11,1,10,4,8,4,0
476,Nacho Vidal,es  ESP,DF,Osasuna,27-340,1995,9.9,22,12,14,3,5,14,26,53.8,12,15,2,13,17,39,21,1
477,Asier Villalibre,es  ESP,FW,Athletic Club,25-091,1997,1.0,0,0,0,0,0,0,0,,0,0,0,0,0,0,1,0
478,Daniel Vivian,es  ESP,DF,Athletic Club,23-168,1999,8.1,13,8,11,2,0,8,9,88.9,1,6,4,2,13,26,29,1
479,Shon Weissman,il  ISR,FW,Valladolid,26-319,1996,6.2,1,1,1,0,0,0,2,0.0,2,7,0,7,1,2,6,0
480,Iñaki Williams,gh  GHA,FW,Athletic Club,28-198,1994,13.5,11,7,2,8,1,5,7,71.4,2,4,2,2,2,13,11,0
481,Nico Williams,es  ESP,FW,Athletic Club,20-171,2002,12.9,14,7,5,5,4,6,10,60.0,4,19,1,18,4,18,3,0
482,Axel Witsel,be  BEL,"DF,MF",Atlético Madrid,33-352,1989,11.9,12,7,7,5,0,6,8,75.0,2,11,6,5,11,23,36,0
483,Jawad El Yamiq,ma  MAR,DF,Valladolid,30-304,1992,4.9,7,3,6,1,0,2,2,100.0,0,7,7,0,13,20,33,0
484,Joseba Zaldúa,es  ESP,DF,Cádiz,30-189,1992,7.1,15,8,10,4,1,7,10,70.0,3,4,2,2,11,26,22,0
485,Oier Zarraga,es  ESP,MF,Athletic Club,23-360,1999,2.7,0,0,0,0,0,0,2,0.0,2,1,0,1,1,1,0,0
486,Igor Zubeldia,es  ESP,DF,Real Sociedad,25-275,1997,8.0,12,6,7,5,0,6,7,85.7,1,9,6,3,7,19,33,0
487,Martín Zubimendi,es  ESP,MF,Real Sociedad,23-331,1999,12.8,23,13,11,11,1,7,13,53.8,6,16,8,8,13,36,26,3
