,Player,Nation,Pos,Squad,Age,Born,90s,Tkl_Tackles,TklW_Tackles,Def 3rd_Tackles,Mid 3rd_Tackles,Att 3rd_Tackles,Tkl_Challenges,Att_Challenges,Tkl%_Challenges,Lost_Challenges,Blocks_Blocks,Sh_Blocks,Pass_Blocks,Int,Tkl+Int,Clr,Err
0,Abner,br  BRA,DF,Atl Paranaense,21,2000,23.4,43,28,26,14,3,24,38,63.2,14,18,3,15,39,82,54,0
1,Adryelson,br  BRA,DF,Botafogo (RJ),23,1998,16.1,17,12,14,3,0,8,10,80.0,2,18,12,6,22,39,99,0
2,Adson,br  BRA,"FW,MF",Corinthians,21,2000,13.8,34,22,15,13,6,12,22,54.5,10,18,0,18,13,47,11,0
3,Airton,br  BRA,FW,Atl Goianiense,22,1999,19.3,32,24,17,8,7,15,39,38.5,24,17,5,12,10,42,12,0
4,Carlos Alberto,br  BRA,"FW,MF",América (MG),19,2002,1.7,1,1,1,0,0,1,4,25.0,3,2,0,2,4,5,0,1
5,Yuri Alberto,br  BRA,FW,Corinthians,20,2001,16.1,12,8,1,6,5,6,13,46.2,7,15,0,15,2,14,8,0
6,Ale,br  BRA,MF,América (MG),31,1990,21.4,50,21,20,22,8,19,37,51.4,18,32,5,27,28,78,36,1
7,Alexandre Alemão,br  BRA,FW,Internacional,23,1998,22.3,22,11,1,14,7,12,25,48.0,13,20,3,17,4,26,11,0
8,Alerrandro,br  BRA,FW,Bragantino,22,2000,10.3,4,1,0,3,1,2,7,28.6,5,10,2,8,4,8,8,0
9,Alesson,br  BRA,"MF,FW",Cuiabá,22,1999,11.4,19,9,8,8,3,11,33,33.3,22,20,1,19,3,22,3,0
10,Alex,br  BRA,DF,Santos,22,1999,3.7,4,3,2,2,0,3,4,75.0,1,8,8,0,8,12,15,0
11,Caio Alexandre,br  BRA,MF,Fortaleza,22,1999,11.0,39,22,19,17,3,21,41,51.2,20,14,4,10,11,50,14,0
12,Matheus Alexandre,br  BRA,DF,Coritiba,22,1999,15.6,35,22,25,9,1,23,35,65.7,12,16,8,8,30,65,36,0
13,Alexsander,br  BRA,DF,Fluminense,18,2003,2.5,5,1,3,0,2,3,6,50.0,3,5,0,5,6,11,2,0
14,Alisson,br  BRA,"MF,FW",São Paulo,28,1993,10.5,15,9,4,9,2,10,22,45.5,12,10,1,9,5,20,8,0
15,Allan,br  BRA,MF,Atlético Mineiro,24,1997,30.4,47,30,21,21,5,24,50,48.0,26,24,7,17,25,72,44,1
16,Guilherme Almeida Augusto,br  BRA,DF,Bragantino,29,1993,1.0,2,2,1,1,0,1,3,33.3,2,2,0,2,2,4,1,0
17,Henrique Almeida,br  BRA,FW,América (MG),30,1991,16.6,18,11,4,9,5,4,15,26.7,11,7,0,7,3,21,9,0
18,Júnior Alonso,py  PAR,DF,Atlético Mineiro,28,1993,28.9,24,14,17,6,1,13,29,44.8,16,28,17,11,28,52,66,0
19,Diego Alves,br  BRA,GK,Flamengo,36,1985,4.7,0,0,0,0,0,0,0,,0,0,0,0,0,0,0,0
20,Rodrigo Alves Soares,br  BRA,DF,Juventude,29,1992,31.0,38,25,25,9,4,29,53,54.7,24,22,5,17,13,51,77,1
21,Anderson,br  BRA,GK,Atl Paranaense,23,1998,5.0,0,0,0,0,0,0,0,,0,0,0,0,0,0,7,1
22,Thonny Anderson,br  BRA,"MF,FW",Coritiba,24,1997,8.1,25,17,6,14,5,12,29,41.4,17,9,4,5,5,30,9,0
23,Andrey,br  BRA,MF,Avaí,19,2002,0.3,0,0,0,0,0,0,0,,0,0,0,0,0,0,0,0
24,Brayan Angulo,ec  ECU,"FW,MF",Santos,26,1995,5.3,4,2,2,2,0,1,6,16.7,5,6,1,5,1,5,4,0
25,Apodi,br  BRA,"MF,FW",Goiás,35,1986,10.1,13,5,9,2,2,5,12,41.7,7,7,3,4,4,17,8,0
26,Guilherme Arana,br  BRA,DF,Atlético Mineiro,24,1997,19.1,22,16,13,7,2,9,16,56.3,7,15,6,9,10,32,25,0
27,Willian Arão,br  BRA,"MF,DF",Flamengo,29,1992,10.2,11,4,7,2,2,7,14,50.0,7,13,10,3,17,28,19,1
28,Michel Araujo,uy  URU,"FW,MF",Fluminense,25,1996,0.9,5,3,2,2,1,2,4,50.0,2,2,0,2,0,5,0,0
29,Robert Arboleda,ec  ECU,DF,São Paulo,30,1991,8.0,8,6,6,2,0,6,7,85.7,1,10,7,3,6,14,52,0
30,Jhon Arias,co  COL,"FW,MF",Fluminense,24,1997,29.6,48,31,14,19,15,21,41,51.2,20,33,2,31,7,55,19,0
31,Artur,br  BRA,"FW,MF",Bragantino,23,1998,31.0,29,18,11,12,6,13,34,38.2,21,32,8,24,15,44,16,0
32,Eduard Atuesta,co  COL,MF,Palmeiras,24,1997,7.3,12,7,4,7,1,3,17,17.6,14,10,1,9,10,22,2,0
33,Felipe Augusto,br  BRA,FW,Corinthians,17,2004,0.8,0,0,0,0,0,0,2,0.0,2,1,0,1,0,0,0,0
34,Leo Augusto Pereira,br  BRA,"FW,MF",Atl Goianiense,21,2000,12.6,24,16,9,12,3,8,29,27.6,21,17,2,15,10,34,5,0
35,Renato Augusto,br  BRA,MF,Corinthians,33,1988,15.6,30,15,10,11,9,10,24,41.7,14,13,1,12,14,44,9,1
36,Auremir,br  BRA,MF,Goiás,30,1991,16.4,46,29,31,15,0,13,26,50.0,13,14,7,7,26,72,27,0
37,Auro,br  BRA,DF,Santos,26,1996,4.3,9,6,5,3,1,5,10,50.0,5,3,1,2,3,12,11,0
38,Danilo Avelar,br  BRA,DF,América (MG),32,1989,9.6,11,8,7,3,1,5,14,35.7,9,11,4,7,16,27,36,1
39,Felipe Azevedo,br  BRA,"MF,FW",América (MG),35,1987,25.3,36,18,14,13,9,12,40,30.0,28,31,2,29,14,50,23,1
40,Matheus Babi,br  BRA,"FW,MF",Atl Paranaense,24,1997,0.9,1,1,0,0,1,0,0,,0,0,0,0,0,1,3,0
41,Pedro Bahia,br  BRA,MF,Goiás,19,2002,0.3,,0,,,,,,,,,,,0,,,
42,Fabrício Baiano,br  BRA,"FW,MF",Fortaleza,29,1992,0.6,5,2,2,3,0,1,2,50.0,1,0,0,0,1,6,4,0
43,Fabián Balbuena,py  PAR,DF,Corinthians,30,1991,12.0,15,11,12,3,0,6,14,42.9,8,12,10,2,12,27,58,0
44,Robson Bambu,br  BRA,DF,Corinthians,24,1997,4.4,10,7,6,4,0,6,11,54.5,5,5,2,3,8,18,27,0
45,Léo Baptistão,br  BRA,"FW,MF",Santos,29,1992,12.6,20,9,5,10,5,8,25,32.0,17,13,3,10,7,27,17,0
46,Gabriel Baralhas,br  BRA,MF,Atl Goianiense,23,1998,24.0,52,37,26,21,5,19,59,32.2,40,30,10,20,35,87,29,0
47,Danilo Barbosa,br  BRA,MF,Botafogo (RJ),25,1996,1.8,4,3,0,3,1,4,5,80.0,1,6,4,2,5,9,8,0
48,Gabriel Barbosa,br  BRA,FW,Flamengo,25,1996,22.7,10,5,2,5,3,5,18,27.8,13,0,0,0,2,12,2,0
49,Lucas Barbosa,br  BRA,"FW,MF",Santos,20,2001,8.6,40,19,14,20,6,15,40,37.5,25,21,3,18,10,50,10,0
50,Danilo Barcelos,br  BRA,"DF,MF",Goiás,30,1991,11.4,20,17,13,5,2,8,20,40.0,12,12,5,7,11,31,28,0
51,Leandro Barcia,uy  URU,FW,Atl Goianiense,29,1992,0.3,2,2,1,1,0,2,3,66.7,1,0,0,0,2,4,1,0
52,Barreto,br  BRA,MF,Botafogo (RJ),26,1995,0.3,3,2,3,0,0,2,2,100.0,0,0,0,0,0,3,0,0
53,Fellipe Bastos,br  BRA,MF,Goiás,31,1990,9.6,23,11,6,14,3,9,28,32.1,19,15,2,13,11,34,24,0
54,Ramiro Benetti,br  BRA,"MF,FW",Corinthians,28,1993,6.1,13,7,5,7,1,4,8,50.0,4,9,1,8,6,19,5,0
55,Martín Benítez,ar  ARG,MF,América (MG),27,1994,8.4,7,6,2,2,3,3,11,27.3,8,12,1,11,5,12,7,0
56,Bento,br  BRA,GK,Atl Paranaense,22,1999,33.0,1,1,1,0,0,1,1,100.0,0,0,0,0,1,2,11,2
57,Lucas Beraldo,br  BRA,DF,São Paulo,18,2003,1.4,4,4,4,0,0,2,4,50.0,2,0,0,0,2,6,6,0
58,Eduardo de Biasi,br  BRA,MF,Avaí,25,1997,20.8,47,19,18,27,2,25,58,43.1,33,12,4,8,12,59,16,0
59,Pedro Bicalho,br  BRA,MF,Palmeiras,20,2001,0.0,1,1,1,0,0,1,1,100.0,0,0,0,0,0,1,0,0
60,Raul Bicalho,br  BRA,DF,Corinthians,22,1999,18.7,28,15,23,5,0,16,25,64.0,9,20,12,8,32,60,63,1
61,Guilherme Bissoli,br  BRA,FW,Avaí,24,1998,27.1,22,14,3,9,10,10,35,28.6,25,21,2,19,13,35,23,0
62,Marcelo Boeck,br  BRA,GK,Fortaleza,37,1984,13.0,0,0,0,0,0,0,0,,0,0,0,0,1,1,6,0
63,Ângelo Borges,br  BRA,"FW,MF",Santos,17,2004,17.0,14,6,3,6,5,3,10,30.0,7,18,0,18,6,20,6,0
64,Daniel Borges,br  BRA,DF,Botafogo (RJ),28,1993,20.8,38,18,27,11,0,20,43,46.5,23,13,3,10,17,55,45,0
65,Douglas Borges,br  BRA,GK,Botafogo (RJ),31,1990,1.0,0,0,0,0,0,0,0,,0,0,0,0,0,0,0,0
66,Marllon Borges,br  BRA,DF,Cuiabá,29,1992,33.4,58,31,42,16,0,25,42,59.5,17,44,29,15,35,93,145,1
67,Lucas Braga,br  BRA,"FW,MF",Santos,25,1996,23.1,23,19,10,7,6,11,24,45.8,13,19,2,17,15,38,21,0
68,David Braz,br  BRA,DF,Fluminense,34,1987,7.9,9,5,7,2,0,5,8,62.5,3,8,5,3,7,16,43,0
69,Breno,br  BRA,FW,Palmeiras,26,1996,3.7,8,2,1,3,4,2,3,66.7,1,1,0,1,1,9,3,0
70,Bressan,br  BRA,DF,Avaí,29,1993,20.6,19,7,12,6,1,9,23,39.1,14,25,19,6,22,41,82,0
71,Emanuel Brítez,ar  ARG,DF,Fortaleza,29,1992,20.0,48,32,28,18,2,31,45,68.9,14,23,10,13,30,78,77,0
72,Bruninho,br  BRA,"MF,FW",Juventude,21,2000,1.3,1,0,0,1,0,1,3,33.3,2,1,0,1,1,2,0,0
73,Bruno,br  BRA,MF,Bragantino,18,2003,0.4,1,1,0,0,1,0,1,0.0,1,1,0,1,0,1,0,0
74,Fabrício Bruno,br  BRA,DF,Flamengo,25,1996,13.0,13,6,12,1,0,6,11,54.5,5,3,3,0,10,23,52,0
75,Ricardo Bueno,br  BRA,FW,Juventude,34,1987,9.0,10,8,1,7,2,2,12,16.7,10,8,2,6,0,10,15,0
76,Vitor Bueno,br  BRA,"MF,FW",Atl Paranaense,27,1994,12.5,8,5,3,5,0,2,13,15.4,11,15,2,13,7,15,13,0
77,Busanello,br  BRA,DF,Juventude,23,1998,3.2,6,4,5,1,0,3,4,75.0,1,2,2,0,8,14,3,0
78,Fabricio Bustos,ar  ARG,DF,Internacional,25,1996,29.7,54,37,39,12,3,35,54,64.8,19,20,9,11,31,85,76,1
79,Nahuel Bustos,ar  ARG,FW,São Paulo,23,1998,3.2,3,2,0,3,0,1,3,33.3,2,2,0,2,0,3,0,0
80,Daniel Cabral,br  BRA,FW,Flamengo,19,2002,0.0,0,0,0,0,0,0,0,,0,0,0,0,0,0,0,0
81,Patric Cabral Lalau,br  BRA,DF,América (MG),32,1989,19.1,40,20,21,17,2,16,33,48.5,17,10,3,7,19,59,54,0
82,Raúl Cáceres,py  PAR,DF,América (MG),30,1991,18.0,35,19,19,10,6,20,45,44.4,25,17,7,10,17,52,28,0
83,Caetano,br  BRA,DF,Goiás,22,1999,24.6,32,19,24,7,1,15,28,53.6,13,26,21,5,37,69,111,0
84,Jonathan Cafu,br  BRA,"DF,MF",Cuiabá,30,1991,6.2,10,6,6,4,0,4,7,57.1,3,4,0,4,1,11,1,0
85,Rodrigo Caio,br  BRA,DF,Flamengo,28,1993,6.5,9,4,6,3,0,4,8,50.0,4,7,6,1,8,17,24,0
86,Calebe,br  BRA,"MF,FW",Atlético Mineiro,21,2000,2.9,10,7,3,6,1,4,7,57.1,3,2,1,1,3,13,1,0
87,Lucas Calegari,br  BRA,DF,Fluminense,19,2002,7.3,10,5,4,3,3,6,11,54.5,5,8,3,5,5,15,10,0
88,Jonathan Calleri,ar  ARG,FW,São Paulo,28,1993,31.3,20,12,1,9,10,8,19,42.1,11,18,2,16,5,25,48,0
89,Guilherme Camacho,br  BRA,MF,Santos,31,1990,18.1,58,26,28,26,4,29,59,49.2,30,29,13,16,18,76,26,0
90,Nathan Camargo,br  BRA,"MF,FW",Bragantino,16,2005,0.8,6,3,5,1,0,4,5,80.0,1,0,0,0,1,7,2,0
91,Camilo,br  BRA,MF,Cuiabá,22,1999,18.5,29,22,9,14,6,13,31,41.9,18,20,8,12,26,55,46,2
92,Camutanga,br  BRA,DF,Atl Goianiense,28,1993,0.8,2,2,1,1,0,2,5,40.0,3,0,0,0,2,4,2,0
93,Luan Cândido,br  BRA,DF,Bragantino,20,2001,29.2,34,21,18,14,2,22,47,46.8,25,21,9,12,32,66,85,0
94,Germán Cano,ar  ARG,FW,Fluminense,33,1988,34.2,17,6,6,8,3,9,25,36.0,16,11,3,8,8,25,24,0
95,Agustín Canobbio,uy  URU,FW,Atl Paranaense,23,1998,15.6,31,16,12,15,4,16,34,47.1,18,19,0,19,7,38,7,0
96,Víctor Cantillo,co  COL,MF,Corinthians,28,1993,10.2,21,12,10,8,3,12,25,48.0,13,11,4,7,12,33,17,0
97,Capixaba,br  BRA,"FW,MF",Juventude,25,1997,18.4,41,27,27,10,4,25,39,64.1,14,18,1,17,19,60,19,0
98,Juninho Capixaba,br  BRA,DF,Fortaleza,24,1997,32.3,77,38,38,26,13,37,75,49.3,38,30,4,26,66,143,80,0
99,Gabriel Carabajal,ar  ARG,"MF,FW",Santos,30,1991,5.5,5,4,3,2,0,1,8,12.5,7,8,1,7,3,8,5,0
100,Johnny Cardoso,us  USA,MF,Internacional,20,2001,15.7,39,22,16,18,5,18,49,36.7,31,23,10,13,39,78,30,0
101,Igor Cariús,br  BRA,"DF,MF",Cuiabá,28,1993,12.9,26,20,16,6,4,15,26,57.7,11,19,6,13,23,49,28,0
102,Joel Carli,ar  ARG,DF,Botafogo (RJ),35,1986,4.1,4,2,4,0,0,3,4,75.0,1,3,2,1,5,9,31,0
103,Ed Carlos,br  BRA,MF,Santos,20,2001,2.9,6,3,4,1,1,2,3,66.7,1,4,0,4,0,6,0,0
104,Jan Carlos Hurtado,ve  VEN,FW,Bragantino,21,2000,5.4,5,1,0,3,2,1,6,16.7,5,3,1,2,3,8,0,0
105,João Carlos,br  BRA,GK,Cuiabá,33,1988,10.6,0,0,0,0,0,0,0,,0,0,0,0,0,0,7,0
106,Alan Carvalho,cn  CHN,"FW,MF",Fluminense,32,1989,0.4,0,0,0,0,0,0,1,0.0,1,0,0,0,0,0,0,0
107,Cássio,br  BRA,GK,Corinthians,34,1987,34.0,1,0,1,0,0,0,1,0.0,1,0,0,0,1,2,15,1
108,Luciano Castán,br  BRA,DF,Coritiba,32,1989,35.0,31,17,22,7,2,19,31,61.3,12,53,43,10,35,66,144,4
109,Iury de Castilho,br  BRA,FW,Ceará,26,1995,5.8,6,3,1,5,0,1,7,14.3,6,6,0,6,1,7,2,1
110,Cauã,br  BRA,DF,Juventude,18,2003,0.5,3,3,3,0,0,1,1,100.0,0,0,0,0,0,3,1,0
111,Matheus Cavichioli,br  BRA,GK,América (MG),35,1986,25.0,1,1,1,0,0,1,1,100.0,0,1,0,1,2,3,18,0
112,Brayan Ceballos,co  COL,DF,Fortaleza,20,2001,11.9,18,9,10,7,1,8,16,50.0,8,11,6,5,14,32,55,1
113,Murilo Cerqueira,br  BRA,DF,Palmeiras,24,1997,31.5,38,21,27,9,2,21,41,51.2,20,51,25,26,39,77,102,0
114,Reynaldo Cesar Moraes,br  BRA,DF,Goiás,25,1997,30.5,42,26,37,5,0,17,29,58.6,12,31,24,7,40,82,191,1
115,Jhon Chancellor,ve  VEN,DF,Coritiba,30,1992,13.0,14,7,12,2,0,7,13,53.8,6,10,9,1,9,23,56,0
116,Arthur Chaves,br  BRA,DF,Avaí,21,2001,16.5,18,15,12,6,0,9,12,75.0,3,22,19,3,13,31,71,1
117,Renato Chaves,br  BRA,DF,Juventude,31,1990,1.8,1,0,1,0,0,1,2,50.0,1,1,1,0,5,6,7,0
118,Chico,br  BRA,"MF,FW",Juventude,30,1991,24.2,54,31,21,23,10,19,39,48.7,20,24,4,20,25,79,21,0
119,Christian,br  BRA,MF,Atl Paranaense,21,2000,4.8,8,6,1,6,1,4,8,50.0,4,3,1,2,5,13,4,0
120,Diego Churín,ar  ARG,FW,Atl Goianiense,32,1989,26.5,31,18,7,20,4,9,32,28.1,23,20,3,17,8,39,24,0
121,Marcelo Cirino,br  BRA,FW,Atl Paranaense,30,1992,5.2,5,3,1,2,2,2,6,33.3,4,7,0,7,5,10,5,0
122,Léo Cittadini,br  BRA,"MF,FW",Atl Paranaense,27,1994,8.0,18,10,9,8,1,7,15,46.7,8,9,0,9,5,23,12,0
123,Luccas Claro,br  BRA,DF,Fluminense,30,1991,5.2,1,1,1,0,0,0,3,0.0,3,3,3,0,8,9,29,0
124,Clayton,br  BRA,"FW,MF",Coritiba,23,1999,3.6,3,1,1,1,1,0,3,0.0,3,2,0,2,0,3,5,0
125,Cléber,br  BRA,FW,Ceará,25,1996,10.9,16,10,2,10,4,3,8,37.5,5,7,1,6,2,18,11,0
126,Jean Cléber,br  BRA,MF,Avaí,31,1990,9.6,16,11,10,5,1,9,12,75.0,3,10,3,7,13,29,9,1
127,Cleiton,br  BRA,DF,Flamengo,18,2003,0.0,,0,,,,,,,,,,,0,,,
128,Andrés Colorado,co  COL,MF,São Paulo,23,1998,3.4,10,9,6,3,1,3,5,60.0,2,4,1,3,5,15,9,1
129,Germán Conti,ar  ARG,DF,América (MG),27,1994,18.4,20,13,9,10,1,7,14,50.0,7,34,22,12,28,48,110,0
130,Jonathan Copete,co  COL,FW,Avaí,34,1988,3.1,5,2,0,4,1,2,4,50.0,2,4,0,4,3,8,6,0
131,Bruno Cortez,br  BRA,DF,Avaí,34,1987,27.0,47,25,26,17,4,31,50,62.0,19,36,8,28,12,59,57,1
132,Talles Costa,br  BRA,MF,São Paulo,19,2002,6.1,11,8,3,8,0,6,11,54.5,5,7,0,7,8,19,3,0
133,Lucas Crispim,br  BRA,"DF,MF",Fortaleza,27,1994,13.0,18,13,9,5,4,14,21,66.7,7,12,0,12,15,33,18,0
134,Daniel Cruz,br  BRA,"FW,DF",Botafogo (RJ),20,2001,0.1,1,1,1,0,0,0,1,0.0,1,0,0,0,0,1,1,0
135,Tomás Cuello,ar  ARG,FW,Atl Paranaense,21,2000,18.0,44,25,21,17,6,16,40,40.0,24,15,2,13,12,56,10,0
136,Víctor Cuesta,ar  ARG,DF,Botafogo (RJ),33,1988,28.5,48,29,32,14,2,31,43,72.1,12,41,27,14,59,107,116,0
137,Andrés D'Alessandro,ar  ARG,FW,Internacional,40,1981,0.8,0,0,0,0,0,0,0,,0,0,0,0,0,0,0,0
138,Adailson Dadá,br  BRA,"MF,FW",Goiás,24,1997,27.9,38,22,24,10,4,13,42,31.0,29,23,2,21,15,53,20,0
139,Daniel,br  BRA,GK,Internacional,27,1994,23.0,0,0,0,0,0,0,2,0.0,2,0,0,0,1,1,8,3
140,Kayke David,br  BRA,"FW,MF",Flamengo,19,2003,0.3,1,0,0,1,0,0,0,,0,0,0,0,0,1,0,0
141,Giorgian De Arrascaeta,uy  URU,MF,Flamengo,27,1994,16.4,37,23,11,17,9,8,22,36.4,14,18,0,18,5,42,5,0
142,Romildo Del Piage,br  BRA,MF,Botafogo (RJ),21,2000,5.7,23,13,10,12,1,12,33,36.4,21,10,2,8,7,30,8,0
143,Denilson,br  BRA,MF,Cuiabá,20,2001,7.8,20,12,9,8,3,6,11,54.5,5,6,1,5,9,29,7,0
144,Valentín Depietri,ar  ARG,"FW,MF",Fortaleza,21,2000,2.6,4,2,1,2,1,1,2,50.0,1,6,0,6,2,6,1,0
145,Deyverson,br  BRA,FW,Cuiabá,30,1991,14.1,7,3,0,5,2,3,7,42.9,4,5,0,5,4,11,24,0
146,Luan Dias,br  BRA,"MF,FW",Goiás,24,1997,8.6,21,12,10,7,4,5,22,22.7,17,8,2,6,9,30,8,0
147,Matheus Dias,br  BRA,MF,Internacional,24,1997,1.2,6,2,4,2,0,2,4,50.0,2,6,3,3,1,7,1,0
148,Juan Díaz,co  COL,MF,Coritiba,20,2001,1.5,7,6,4,2,1,1,1,100.0,0,3,0,3,1,8,4,0
149,Dieguinho,br  BRA,"MF,DF",Goiás,26,1995,32.1,65,39,29,27,9,26,59,44.1,33,41,16,25,35,100,85,0
150,Dodô,br  BRA,DF,Atlético Mineiro,29,1992,10.1,16,11,9,6,1,7,10,70.0,3,10,0,10,13,29,15,0
151,Matheus Donelli,br  BRA,GK,Corinthians,19,2002,2.0,0,0,0,0,0,0,0,,0,0,0,0,0,0,0,0
152,Renan dos Santos,br  BRA,GK,Atl Goianiense,32,1989,16.0,0,0,0,0,0,0,2,0.0,2,0,0,0,0,0,17,2
153,Douglas,br  BRA,DF,Bragantino,33,1988,0.8,,1,,,,,,,,,,,0,,,
154,Rodrigo Dourado,br  BRA,MF,Internacional,27,1994,5.0,16,6,6,8,2,7,16,43.8,9,5,0,5,7,23,10,0
155,David Duarte,br  BRA,DF,Fluminense,27,1995,0.9,1,1,0,1,0,0,1,0.0,1,1,1,0,4,5,11,0
156,Pablo Dyego,br  BRA,FW,Avaí,27,1994,5.4,11,7,9,1,1,5,12,41.7,7,7,2,5,6,17,5,0
157,Edenílson,br  BRA,MF,Internacional,32,1989,24.3,38,22,16,16,6,17,29,58.6,12,18,4,14,15,53,26,0
158,Eder,br  BRA,DF,América (MG),26,1995,32.7,23,13,16,7,0,14,28,50.0,14,46,35,11,54,77,153,0
159,Éder,it  ITA,"FW,MF",São Paulo,35,1986,7.4,5,5,1,1,3,1,5,20.0,4,4,1,3,1,6,1,0
160,Edinho,br  BRA,MF,Juventude,27,1994,4.1,,0,,,,,,,,,,,1,,,
161,Elton,br  BRA,MF,Juventude,31,1990,12.9,29,18,17,10,2,15,25,60.0,10,14,5,9,20,49,19,0
162,Leandro Emmanuel Martínez,ar  ARG,MF,América (MG),27,1994,2.9,10,6,3,3,4,2,3,66.7,1,3,0,3,3,13,1,0
163,Alan Empereur,br  BRA,DF,Cuiabá,27,1994,24.7,18,9,12,5,1,5,11,45.5,6,18,15,3,38,56,89,1
164,Endrick,br  BRA,FW,Palmeiras,15,2006,3.4,4,4,1,1,2,1,1,100.0,0,3,0,3,0,4,0,0
165,Erison,br  BRA,FW,Botafogo (RJ),22,1999,16.5,4,3,0,2,2,2,9,22.2,7,5,0,5,1,5,10,0
166,Estevão,br  BRA,"FW,MF",Internacional,19,2002,1.2,2,1,2,0,0,2,2,100.0,0,2,1,1,1,3,0,0
167,Lucas Evangelista,br  BRA,MF,Bragantino,26,1995,29.0,60,36,22,32,6,28,55,50.9,27,24,10,14,27,87,36,0
168,Everaldo,br  BRA,"MF,FW",América (MG),27,1994,21.0,30,17,12,10,8,6,33,18.2,27,21,1,20,16,46,7,0
169,Éverson,br  BRA,GK,Atlético Mineiro,31,1990,37.0,0,0,0,0,0,0,1,0.0,1,1,0,1,0,0,16,0
170,Éverton,br  BRA,"MF,FW",Cuiabá,33,1988,4.4,7,6,2,5,0,5,14,35.7,9,5,0,5,4,11,3,0
171,Fabinho,br  BRA,MF,Palmeiras,19,2002,0.8,3,3,0,2,1,1,4,25.0,3,0,0,0,2,5,2,0
172,Fabrício,br  BRA,"FW,MF",Coritiba,24,1997,16.7,29,19,12,16,1,11,24,45.8,13,22,1,21,7,36,13,0
173,Fagner,br  BRA,DF,Corinthians,32,1989,10.0,34,21,22,8,4,16,23,69.6,7,8,3,5,11,45,21,0
174,Willian Farias,br  BRA,MF,Coritiba,32,1989,17.7,31,21,14,15,2,11,35,31.4,24,16,4,12,19,50,24,0
175,Lucas Fasson,br  BRA,DF,Atl Paranaense,20,2001,0.8,0,0,0,0,0,0,0,,0,0,0,0,1,1,4,0
176,Felipe,br  BRA,MF,Fortaleza,27,1994,9.8,13,7,5,8,0,7,16,43.8,9,9,1,8,13,26,17,0
177,Luis Felipe,br  BRA,DF,Santos,28,1993,10.9,,9,,,,,,,,,,,18,,,
178,Matheus Felipe,br  BRA,DF,Atl Paranaense,23,1998,19.8,27,20,18,9,0,16,26,61.5,10,29,20,9,17,44,84,0
179,Lucas Fernandes,br  BRA,MF,Botafogo (RJ),24,1997,18.6,19,10,5,11,3,10,35,28.6,25,19,5,14,8,27,8,0
180,Matheus Fernandes,br  BRA,MF,Atl Paranaense,23,1998,7.6,25,13,15,7,3,10,28,35.7,18,19,3,16,9,34,13,0
181,Gatito Fernández,py  PAR,GK,Botafogo (RJ),33,1988,31.2,3,1,3,0,0,3,6,50.0,3,0,0,0,2,5,13,0
182,Ignacio Fernández,ar  ARG,MF,Atlético Mineiro,32,1990,24.7,47,24,14,18,15,21,70,30.0,49,32,2,30,21,68,7,0
183,Rodrigo Fernández,uy  URU,MF,Santos,26,1996,25.7,89,52,43,40,6,50,131,38.2,81,27,5,22,20,109,32,0
184,Fernandinho,br  BRA,MF,Atl Paranaense,36,1985,10.8,16,8,4,10,2,3,12,25.0,9,13,4,9,11,27,8,1
185,Derick Fernando,br  BRA,DF,Santos,19,2002,0.2,0,0,0,0,0,0,0,,0,1,1,0,0,0,0,0
186,Luiz Fernando,br  BRA,"FW,MF",Atl Goianiense,25,1996,19.4,17,10,9,6,2,4,17,23.5,13,12,1,11,11,28,18,0
187,Nahuel Ferraresi,ve  VEN,DF,São Paulo,23,1998,7.9,18,11,12,6,0,9,17,52.9,8,16,7,9,12,30,30,0
188,Luiz Filipe,br  BRA,"MF,FW",Goiás,20,2001,0.4,4,1,2,1,1,1,1,100.0,0,1,1,0,0,4,0,0
189,Flávio,br  BRA,MF,América (MG),21,2000,0.3,2,2,2,0,0,2,3,66.7,1,0,0,0,2,4,0,0
190,Rafael Forster,br  BRA,DF,Juventude,31,1990,18.1,25,18,18,4,3,15,27,55.6,12,17,13,4,26,51,82,0
191,Matheus França,br  BRA,"FW,MF",Flamengo,17,2004,7.5,15,5,5,8,2,5,6,83.3,1,4,0,4,3,18,8,0
192,Fred,br  BRA,"FW,MF",Fluminense,38,1983,1.4,1,0,0,0,1,1,1,100.0,0,0,0,0,0,1,3,0
193,Marlon Freitas,br  BRA,MF,Atl Goianiense,26,1995,27.5,46,29,24,17,5,24,55,43.6,31,29,15,14,28,74,32,1
194,Douglas Friedrich,br  BRA,GK,Avaí,33,1988,10.4,0,0,0,0,0,0,1,0.0,1,0,0,0,0,0,9,1
195,Eduardo Gabriel,br  BRA,DF,Santos,25,1996,33.0,34,17,25,8,1,12,19,63.2,7,55,39,16,49,83,147,1
196,Luiz Gabriel,br  BRA,"FW,MF",Coritiba,19,2002,1.1,7,3,5,1,1,3,5,60.0,2,0,0,0,3,10,1,0
197,Marquinhos Gabriel,br  BRA,"MF,FW",Goiás,31,1990,8.4,10,6,3,5,2,5,7,71.4,2,8,1,7,1,11,2,0
198,Vitor Gabriel,br  BRA,"FW,MF",Juventude,22,2000,8.6,10,3,4,3,3,4,12,33.3,8,5,1,4,0,10,19,0
199,Matías Galarza,py  PAR,MF,Coritiba,19,2002,6.7,24,9,5,14,5,11,30,36.7,19,11,3,8,13,37,4,0
200,Matheus Galdezani,br  BRA,MF,Avaí,29,1992,3.2,12,8,3,6,3,7,10,70.0,3,5,2,3,6,18,2,0
201,Thiago Galhardo,br  BRA,"FW,MF",Fortaleza,32,1989,15.0,13,7,2,6,5,1,16,6.3,15,8,0,8,6,19,18,0
202,Giuliano Galoppo,ar  ARG,MF,São Paulo,22,1999,7.9,16,11,2,10,4,6,19,31.6,13,8,0,8,3,19,5,0
203,Léo Gamalho,br  BRA,FW,Coritiba,36,1986,18.4,12,6,3,5,4,4,11,36.4,7,4,2,2,0,12,12,0
204,Ganso,br  BRA,"MF,FW",Fluminense,32,1989,27.5,40,22,12,20,8,13,38,34.2,25,22,4,18,9,49,9,0
205,García,br  BRA,"DF,MF",Palmeiras,20,2002,1.1,2,0,2,0,0,0,0,,0,0,0,0,2,4,3,0
206,Bryan García,ec  ECU,MF,Atl Paranaense,21,2001,3.1,4,4,1,3,0,2,13,15.4,11,3,0,3,2,6,7,0
207,Luan Garcia,br  BRA,DF,Palmeiras,28,1993,13.6,15,4,10,4,1,8,14,57.1,6,14,8,6,22,37,53,1
208,Gaspar,br  BRA,FW,Avaí,19,2002,0.4,4,2,1,0,3,3,5,60.0,2,1,0,1,1,5,0,0
209,Rafael Gava,br  BRA,MF,Cuiabá,28,1993,22.7,31,17,11,14,6,17,42,40.5,25,19,5,14,15,46,19,0
210,Lucas Gazal,br  BRA,DF,Atl Goianiense,22,1999,14.5,9,4,9,0,0,5,6,83.3,1,16,12,4,16,25,79,0
211,Guilherme Gehring,br  BRA,MF,Juventude,16,2005,0.1,0,0,0,0,0,0,0,,0,0,0,0,0,0,0,0
212,Geovane,br  BRA,MF,Ceará,22,1999,6.1,11,4,1,8,2,5,11,45.5,6,11,4,7,5,16,4,0
213,Gil,br  BRA,DF,Corinthians,34,1987,22.7,30,13,20,7,3,13,21,61.9,8,35,25,10,29,59,77,0
214,Giovane,br  BRA,"FW,DF",Corinthians,18,2003,3.3,6,2,1,4,1,2,4,50.0,2,5,2,3,1,7,1,0
215,Giovani,br  BRA,"FW,MF",Palmeiras,18,2004,0.4,0,0,0,0,0,0,0,,0,2,0,2,0,0,0,0
216,Glédson,br  BRA,GK,Avaí,38,1983,5.0,0,0,0,0,0,0,0,,0,0,0,0,0,0,1,0
217,Diego Godín,uy  URU,DF,Atlético Mineiro,35,1986,1.0,2,2,2,0,0,0,2,0.0,2,0,0,0,2,4,1,0
218,Bruno Gomes,br  BRA,MF,Coritiba,20,2001,16.6,40,21,21,15,4,20,36,55.6,16,20,4,16,23,63,7,0
219,João Gomes,br  BRA,MF,Flamengo,20,2001,20.9,92,51,37,45,10,31,75,41.3,44,24,3,21,26,118,32,0
220,Gustavo Gómez,py  PAR,DF,Palmeiras,28,1993,30.0,39,21,28,10,1,17,29,58.6,12,45,30,15,48,87,97,0
221,Aloísio dos Santos Gonçalves,cn  CHN,"FW,MF",América (MG),33,1988,10.5,12,8,4,5,3,3,15,20.0,12,9,0,9,4,16,9,0
222,Diego Gonçalves,br  BRA,FW,Botafogo (RJ),27,1994,5.4,5,3,2,3,0,1,8,12.5,7,5,0,5,2,7,6,0
223,Matheus Gonçalves,br  BRA,FW,Flamengo,16,2005,0.3,0,0,0,0,0,0,0,,0,1,0,1,0,0,0,0
224,Ricardo Goulart,br  BRA,"MF,FW",Santos,30,1991,4.5,3,3,2,0,1,0,1,0.0,1,2,0,2,1,4,6,0
225,Daniel Guedes,br  BRA,"DF,MF",Cuiabá,27,1994,8.8,15,9,6,6,3,8,23,34.8,15,9,2,7,15,30,10,0
226,Roger Guedes,br  BRA,"FW,MF",Corinthians,25,1996,28.3,8,3,1,3,4,1,6,16.7,5,7,1,6,3,11,10,0
227,Paolo Guerrero,pe  PER,FW,Avaí,38,1984,4.8,2,0,0,2,0,0,2,0.0,2,1,0,1,1,3,4,0
228,Guga,br  BRA,DF,Atlético Mineiro,23,1998,18.6,57,35,30,23,4,30,45,66.7,15,21,4,17,27,84,24,1
229,Gustavinho,br  BRA,MF,América (MG),20,2001,4.3,16,9,2,9,5,9,18,50.0,9,10,0,10,4,20,5,0
230,Habraão,br  BRA,DF,Fortaleza,20,2001,2.4,5,2,4,1,0,4,5,80.0,1,9,8,1,1,6,20,0
231,Hayner,br  BRA,DF,Atl Goianiense,26,1995,15.3,14,10,8,2,4,8,17,47.1,9,10,4,6,22,36,46,0
232,Heitor,br  BRA,DF,Internacional,21,2000,4.4,17,13,8,8,1,11,17,64.7,6,3,1,2,9,26,4,0
233,Thiago Heleno,br  BRA,DF,Atl Paranaense,33,1988,12.7,12,6,8,4,0,8,14,57.1,6,12,10,2,23,35,34,1
234,Helinho,br  BRA,"FW,MF",Bragantino,21,2000,19.0,28,15,15,8,5,16,33,48.5,17,28,1,27,19,47,20,0
235,Henrique,br  BRA,DF,Coritiba,35,1986,17.9,19,12,16,3,0,13,18,72.2,5,30,25,5,21,40,71,0
236,Arthur Henrique,br  BRA,DF,Atl Goianiense,27,1994,10.7,33,19,21,9,3,19,33,57.6,14,8,3,5,16,49,28,0
237,Bruno Henrique,br  BRA,"FW,MF",Flamengo,31,1990,6.8,12,8,4,6,2,4,9,44.4,5,5,0,5,4,16,7,0
238,Daniel Henrique,br  BRA,FW,Ceará,17,2004,0.3,0,0,0,0,0,0,0,,0,0,0,0,0,0,0,0
239,Gustavo Henrique,br  BRA,DF,Flamengo,28,1993,3.8,4,3,3,1,0,2,4,50.0,2,7,6,1,5,9,27,0
240,Luis Henrique,br  BRA,"FW,MF",Botafogo (RJ),20,2001,2.9,5,1,3,0,2,3,3,100.0,0,4,0,4,3,8,1,0
241,Luiz Henrique,br  BRA,"FW,MF",Fluminense,21,2001,11.7,30,19,11,10,9,13,23,56.5,10,16,3,13,9,39,10,0
242,Paulo Henrique,br  BRA,"DF,MF",Juventude,25,1996,16.7,47,27,30,13,4,20,37,54.1,17,11,0,11,11,58,26,0
243,Hércules,br  BRA,"MF,FW",Fortaleza,21,2000,15.2,38,16,19,17,2,13,36,36.1,23,23,3,20,10,48,9,0
244,Nicolás Hernández,co  COL,DF,Atl Paranaense,24,1998,18.0,32,17,21,11,0,21,27,77.8,6,30,15,15,22,54,67,0
245,Victor Hugo,br  BRA,MF,Flamengo,17,2004,13.9,24,11,7,13,4,10,26,38.5,16,8,3,5,11,35,20,0
246,Vitor Hugo,br  BRA,FW,Goiás,17,2004,0.0,0,0,0,0,0,0,0,,0,0,0,0,0,0,0,0
247,Hulk,br  BRA,FW,Atlético Mineiro,35,1986,23.2,11,6,0,7,4,4,17,23.5,13,4,0,4,3,14,12,0
248,José Hurtado,ec  ECU,DF,Bragantino,20,2001,6.6,19,11,12,4,3,13,16,81.3,3,6,3,3,5,24,13,0
249,Hyoran,br  BRA,MF,Bragantino,28,1993,14.2,22,16,9,9,4,7,21,33.3,14,17,3,14,10,32,7,0
250,Igor,br  BRA,"MF,FW",Flamengo,18,2003,0.3,4,0,3,1,0,0,1,0.0,1,1,1,0,0,4,0,0
251,André Inácio,br  BRA,FW,Flamengo,19,2002,0.5,0,0,0,0,0,0,0,,0,1,0,1,0,0,0,0
252,Mauricio Isla,cl  CHI,DF,Flamengo,33,1988,3.8,3,3,1,2,0,3,3,100.0,0,3,1,2,6,9,6,0
253,Jadsom,br  BRA,MF,Bragantino,20,2001,14.1,26,18,17,8,1,14,33,42.4,19,22,8,14,34,60,25,0
254,Jadson,br  BRA,MF,Juventude,28,1993,29.1,64,46,28,28,8,28,55,50.9,27,23,6,17,24,88,19,1
255,Jailson,br  BRA,GK,América (MG),40,1981,12.0,0,0,0,0,0,0,0,,0,0,0,0,0,0,6,0
256,Jair,br  BRA,MF,Atlético Mineiro,27,1994,23.0,65,41,25,31,9,28,51,54.9,23,37,4,33,32,97,10,0
257,Jandrei,br  BRA,GK,São Paulo,28,1993,18.3,0,0,0,0,0,0,0,,0,0,0,0,1,1,12,1
258,Vinícius Jaú,br  BRA,MF,Avaí,23,1998,0.1,0,0,0,0,0,0,0,,0,0,0,0,0,0,0,0
259,Pablo Javier García,uy  URU,FW,Coritiba,22,1999,0.1,1,1,1,0,0,1,1,100.0,0,0,0,0,0,1,0,0
260,Jean,br  BRA,MF,Juventude,27,1994,13.1,48,30,24,20,4,31,61,50.8,30,21,11,10,39,87,35,0
261,Jemerson,br  BRA,DF,Atlético Mineiro,29,1992,11.1,18,8,10,7,1,10,14,71.4,4,9,4,5,10,28,33,0
262,Jenison,br  BRA,FW,Cuiabá,30,1991,3.6,1,1,0,1,0,0,2,0.0,2,3,0,3,2,3,5,0
263,Alexandre Jesus,br  BRA,"MF,DF",Fluminense,20,2001,0.7,0,0,0,0,0,0,0,,0,0,0,0,5,5,0,0
264,Joaquim,br  BRA,DF,Cuiabá,23,1998,23.9,41,28,31,8,2,25,35,71.4,10,26,14,12,36,77,127,1
265,John,br  BRA,GK,Santos,25,1996,1.0,0,0,0,0,0,0,0,,0,0,0,0,0,0,0,0
266,Jonas,br  BRA,MF,São Paulo,22,1999,0.3,0,0,0,0,0,0,0,,0,0,0,0,1,1,0,0
267,Felipe Jonatan,br  BRA,DF,Santos,23,1998,23.0,28,17,16,11,1,16,23,69.6,7,13,7,6,34,62,70,0
268,Jonathan,br  BRA,DF,Botafogo (RJ),23,1998,0.5,1,1,0,1,0,1,2,50.0,1,0,0,0,1,2,0,0
269,Jorge,br  BRA,DF,Palmeiras,25,1996,5.2,15,8,3,10,2,6,16,37.5,10,8,1,7,3,18,10,0
270,Jorginho,br  BRA,MF,Atl Goianiense,31,1991,18.2,33,18,11,13,9,10,28,35.7,18,16,1,15,6,39,26,0
271,Jhojan Julio,ec  ECU,"FW,MF",Santos,23,1998,9.2,24,13,11,9,4,4,17,23.5,13,11,2,9,9,33,5,0
272,Renato Junior,br  BRA,"FW,MF",Goiás,19,2002,5.5,13,4,3,6,4,5,8,62.5,3,8,0,8,2,15,5,0
273,Jussa,br  BRA,"MF,DF",Fortaleza,25,1996,7.0,2,1,1,1,0,1,10,10.0,9,10,0,10,8,10,10,0
274,Kaiky,br  BRA,DF,Santos,18,2004,1.0,0,0,0,0,0,0,1,0.0,1,0,0,0,2,2,5,0
275,Lucas Kal,br  BRA,MF,América (MG),25,1996,24.0,38,19,15,19,4,13,34,38.2,21,27,8,19,32,70,49,0
276,Kanu,br  BRA,DF,Botafogo (RJ),24,1997,16.1,19,10,14,5,0,9,16,56.3,7,15,12,3,23,42,67,0
277,Alan Kardec,br  BRA,"FW,MF",Atlético Mineiro,33,1989,2.9,1,1,1,0,0,0,1,0.0,1,3,0,3,0,1,2,0
278,Kauan,br  BRA,FW,Bragantino,18,2003,0.3,0,0,0,0,0,0,0,,0,1,0,1,0,0,1,0
279,Kawê,br  BRA,"MF,FW",América (MG),19,2002,0.3,0,0,0,0,0,0,2,0.0,2,1,0,1,0,0,1,0
280,Kayque,br  BRA,MF,Botafogo (RJ),21,2000,3.1,6,5,1,5,0,1,7,14.3,6,6,0,6,2,8,1,0
281,Renato Kayser,br  BRA,FW,Fortaleza,25,1996,1.8,2,0,2,0,0,1,4,25.0,3,2,0,2,0,2,1,0
282,Gabriel Kazu,br  BRA,MF,Avaí,22,1999,0.0,0,0,0,0,0,0,0,,0,1,0,1,1,1,0,0
283,Keiller,br  BRA,GK,Internacional,25,1996,15.0,0,0,0,0,0,0,2,0.0,2,0,0,0,0,0,7,0
284,Thalisson Kelven,br  BRA,DF,Juventude,23,1998,20.0,17,13,14,2,1,11,16,68.8,5,34,27,7,31,48,109,0
285,Kelvi,br  BRA,MF,Juventude,19,2002,0.5,2,1,0,2,0,1,1,100.0,0,0,0,0,0,2,1,0
286,Kelvin,br  BRA,"MF,FW",Atl Goianiense,24,1997,3.4,3,3,0,3,0,2,4,50.0,2,1,0,1,1,4,4,0
287,Kelvyn,br  BRA,"FW,DF",Ceará,22,1999,0.6,1,1,0,1,0,1,1,100.0,0,0,0,0,0,1,1,0
288,John Kennedy,br  BRA,"FW,MF",Fluminense,19,2002,1.6,0,0,0,0,0,0,0,,0,0,0,0,1,1,0,0
289,Keno,br  BRA,"FW,MF",Atlético Mineiro,32,1989,20.6,42,20,11,20,11,15,29,51.7,14,28,4,24,3,45,8,0
290,Kevin,br  BRA,DF,Avaí,24,1997,29.2,61,40,37,20,4,31,67,46.3,36,32,7,25,37,98,73,1
291,Khellven,br  BRA,DF,Atl Paranaense,20,2001,23.4,50,25,29,18,3,23,42,54.8,19,24,8,16,39,89,69,0
292,Benjamín Kuscevic,cl  CHI,DF,Palmeiras,25,1996,3.3,10,4,7,3,0,3,3,100.0,0,2,1,1,9,19,4,0
293,Gabriel Lacerda,br  BRA,DF,Ceará,22,1999,20.0,21,14,18,3,0,8,18,44.4,10,22,16,6,21,42,86,0
294,Anthony Landazuri,ec  ECU,DF,Fortaleza,24,1997,5.8,6,4,4,1,1,3,6,50.0,3,6,1,5,8,14,9,0
295,Thauan Lara,br  BRA,"DF,FW",Internacional,18,2004,3.8,8,6,8,0,0,6,6,100.0,0,4,0,4,4,12,9,0
296,Lázaro,br  BRA,"FW,MF",Flamengo,19,2002,9.1,15,7,6,5,4,8,24,33.3,16,9,1,8,3,18,7,0
297,Anderson Leite,br  BRA,MF,Juventude,28,1993,0.8,2,1,1,1,0,1,5,20.0,4,2,2,0,4,6,2,0
298,Vinícius Leite,br  BRA,MF,Avaí,28,1993,1.5,4,2,0,3,1,4,6,66.7,2,2,1,1,6,10,0,0
299,Bernanrdo Lemes,br  BRA,"MF,FW",Coritiba,20,2002,10.5,33,15,13,18,2,20,32,62.5,12,10,4,6,16,49,17,0
300,Marcos Leonardo,br  BRA,FW,Santos,18,2003,32.0,4,2,0,3,1,1,11,9.1,10,11,1,10,2,6,33,0
301,Vitor Leque,br  BRA,"MF,DF",Juventude,21,2001,0.6,0,0,0,0,0,0,0,,0,0,0,0,0,0,0,0
302,Lima,br  BRA,"FW,MF",Ceará,25,1996,21.5,39,23,9,23,7,19,50,38.0,31,26,5,21,18,57,13,0
303,Anderson Lima,br  BRA,"MF,FW",São Paulo,22,1999,2.3,11,6,3,8,0,8,11,72.7,3,2,1,1,1,12,1,0
304,Rodrigo Lindoso,br  BRA,MF,Ceará,32,1989,9.6,13,7,3,8,2,6,17,35.3,11,14,6,8,7,20,15,0
305,Liziero,br  BRA,MF,Internacional,23,1998,5.6,24,12,17,7,0,10,19,52.6,9,12,1,11,7,31,8,0
306,David Loiola,br  BRA,DF,Ceará,19,2002,4.4,6,2,6,0,0,3,5,60.0,2,5,4,1,4,10,18,0
307,Marcelo Lomba,br  BRA,GK,Palmeiras,35,1986,3.0,0,0,0,0,0,0,0,,0,0,0,0,0,0,1,0
308,Kevin Lomónaco,ar  ARG,DF,Bragantino,20,2002,12.4,10,6,7,3,0,6,9,66.7,3,12,6,6,9,19,34,1
309,José López,ar  ARG,FW,Palmeiras,21,2000,6.1,5,2,0,2,3,1,6,16.7,5,5,2,3,1,6,6,0
310,Henrique Lordelo,br  BRA,"MF,DF",Goiás,21,2000,1.4,5,4,2,3,0,2,2,100.0,0,4,1,3,2,7,2,0
311,Guillermo de los Santos,uy  URU,DF,Coritiba,30,1991,10.5,14,12,11,3,0,9,12,75.0,3,17,10,7,17,31,53,0
312,Lucão,br  BRA,GK,Bragantino,20,2001,1.0,0,0,0,0,0,0,0,,0,0,0,0,0,0,2,0
313,Lucas,br  BRA,DF,Santos,20,2001,16.2,45,22,28,13,4,21,42,50.0,21,17,5,12,13,58,25,0
314,Ayrton Lucas,br  BRA,DF,Flamengo,24,1997,28.4,63,39,28,33,2,36,60,60.0,24,26,10,16,27,90,52,1
315,João Lucas,br  BRA,"DF,MF",Cuiabá,23,1998,23.8,71,46,45,16,10,41,70,58.6,29,24,6,18,33,104,67,1
316,Luciano,br  BRA,FW,São Paulo,28,1993,22.6,17,9,4,10,3,8,25,32.0,17,23,4,19,7,24,11,0
317,André Luis,br  BRA,"FW,MF",Cuiabá,24,1997,20.4,23,13,9,11,3,7,24,29.2,17,16,4,12,7,30,10,0
318,Filipe Luís,br  BRA,DF,Flamengo,36,1985,7.1,20,12,7,9,4,10,12,83.3,2,7,1,6,12,32,10,0
319,Victor Luis,br  BRA,DF,Ceará,28,1993,15.7,17,9,7,9,1,6,20,30.0,14,11,7,4,15,32,30,0
320,David Luiz,br  BRA,DF,Flamengo,34,1987,15.8,13,4,5,7,1,5,7,71.4,2,15,12,3,13,26,48,0
321,Luizão,br  BRA,DF,São Paulo,19,2002,11.0,14,10,10,3,1,8,17,47.1,9,18,7,11,10,24,54,0
322,Vinícius Machado,br  BRA,GK,Ceará,21,2000,2.0,0,0,0,0,0,0,0,,0,0,0,0,0,0,0,0
323,Mádson,br  BRA,DF,Santos,30,1992,23.8,37,25,20,17,0,21,32,65.6,11,26,18,8,32,69,59,2
324,Maguinho,br  BRA,"DF,MF",Goiás,29,1993,21.6,41,26,24,10,7,18,31,58.1,13,19,11,8,34,75,68,0
325,Gustavo Maia,br  BRA,FW,Internacional,21,2001,0.2,0,0,0,0,0,0,0,,0,0,0,0,1,1,0,0
326,Leonardo Maia,br  BRA,MF,Bragantino,18,2003,0.3,,0,,,,,,,,,,,0,,,
327,Pablo Maia,br  BRA,MF,São Paulo,20,2002,22.8,41,19,24,17,0,20,44,45.5,24,36,9,27,21,62,29,1
328,Thiago Maia,br  BRA,MF,Flamengo,24,1997,17.2,44,26,17,21,6,22,45,48.9,23,18,7,11,24,68,27,0
329,Maicon,br  BRA,DF,Santos,33,1988,21.3,29,20,22,7,0,23,36,63.9,13,38,25,13,29,58,113,1
330,Iago Maidana,br  BRA,DF,América (MG),25,1996,11.5,8,6,6,2,0,4,11,36.4,7,6,5,1,8,16,63,0
331,Léo Mana,br  BRA,DF,Corinthians,17,2004,0.5,0,0,0,0,0,0,0,,0,0,0,0,3,3,1,0
332,Alef Manga,br  BRA,"FW,MF",Coritiba,27,1994,27.0,42,23,14,17,11,16,33,48.5,17,39,0,39,15,57,16,0
333,Manoel,br  BRA,DF,Fluminense,31,1990,27.2,22,12,11,11,0,13,21,61.9,8,26,21,5,22,44,93,1
334,Gustavo Mantuan,br  BRA,"FW,DF",Corinthians,20,2001,9.6,14,7,6,7,1,2,16,12.5,14,13,2,11,7,21,12,0
335,Luis Manuel Orejuela,co  COL,DF,Atl Paranaense,26,1995,13.0,25,14,15,7,3,15,26,57.7,11,8,2,6,10,35,28,0
336,Maranhão,br  BRA,FW,Botafogo (RJ),19,2002,1.0,,1,,,,,,,,,,,0,,,
337,Fernando Marçal,br  BRA,DF,Botafogo (RJ),32,1989,17.1,38,21,22,13,3,17,35,48.6,18,23,5,18,34,72,38,0
338,Marcelo,br  BRA,DF,Fortaleza,26,1996,29.0,34,20,22,11,1,21,39,53.8,18,36,27,9,52,86,150,0
339,Marcinho,br  BRA,"FW,MF",Avaí,26,1995,5.8,12,9,4,5,3,7,10,70.0,3,9,1,8,1,13,2,0
340,Mariano,br  BRA,DF,Atlético Mineiro,35,1986,19.2,43,30,21,18,4,24,55,43.6,31,17,1,16,23,66,28,1
341,Marinho,br  BRA,FW,Flamengo,31,1990,15.3,26,12,10,10,6,11,26,42.3,15,14,1,13,7,33,6,1
342,Rodriguinho Marinho,br  BRA,"FW,MF",Cuiabá,33,1988,16.5,16,6,3,9,4,7,17,41.2,10,12,1,11,4,20,5,0
343,Marlos,ua  UKR,"MF,FW",Atl Paranaense,33,1988,1.7,1,0,1,0,0,1,1,100.0,0,2,0,2,0,1,0,0
344,Felipe Marques,br  BRA,"FW,MF",Cuiabá,32,1990,10.6,8,7,3,2,3,1,13,7.7,12,9,2,7,13,21,5,0
345,Gustavo Marques,br  BRA,DF,América (MG),20,2001,0.5,0,0,0,0,0,0,0,,0,0,0,0,0,0,4,0
346,Marrony,br  BRA,"FW,MF",Fluminense,22,1999,2.0,6,3,2,1,3,1,1,100.0,0,6,0,6,1,7,3,0
347,Matheus Martinelli,br  BRA,MF,Fluminense,20,2001,18.0,42,26,16,19,7,15,25,60.0,10,27,11,16,14,56,22,0
348,Adrián Martínez,ar  ARG,"FW,MF",Coritiba,29,1992,11.1,7,5,2,2,3,2,11,18.2,9,6,0,6,4,11,3,0
349,Matheus Martins,br  BRA,"FW,MF",Fluminense,18,2003,17.8,30,15,8,13,9,5,18,27.8,13,16,4,12,10,40,11,0
350,Wellington Martins,br  BRA,MF,Fluminense,31,1991,7.0,10,3,6,4,0,6,11,54.5,5,8,5,3,7,17,10,0
351,Gonzalo Mastriani,uy  URU,FW,América (MG),28,1993,5.2,2,2,0,1,1,1,4,25.0,3,4,0,4,0,2,4,0
352,Mateusão,br  BRA,"FW,MF",Flamengo,17,2004,2.5,1,0,0,1,0,0,2,0.0,2,1,0,1,0,1,5,0
353,William Matheus,br  BRA,DF,Juventude,31,1990,10.1,13,6,6,6,1,7,8,87.5,1,9,5,4,5,18,41,0
354,Matheusinho,br  BRA,"MF,FW",América (MG),23,1998,15.3,25,16,6,11,8,10,24,41.7,14,10,2,8,17,42,5,0
355,Matheuzinho,br  BRA,DF,Flamengo,21,2000,23.9,53,38,29,18,6,30,45,66.7,15,25,8,17,26,79,43,0
356,Diego Matos,br  BRA,DF,Avaí,25,1997,1.2,4,3,3,0,1,3,4,75.0,1,2,0,2,2,6,3,0
357,Mauricio,br  BRA,"FW,MF",Internacional,20,2001,17.4,19,8,5,9,5,6,23,26.1,17,10,1,9,16,35,10,0
358,Maycon,br  BRA,MF,Corinthians,24,1997,8.8,12,3,8,3,1,8,26,30.8,18,9,3,6,11,23,10,1
359,Mayke,br  BRA,"DF,FW",Palmeiras,29,1992,16.3,34,20,14,14,6,14,31,45.2,17,20,4,16,30,64,27,0
360,Bruno Melo,br  BRA,"DF,MF",Corinthians,29,1992,4.9,3,3,1,1,1,3,4,75.0,1,4,1,3,3,6,13,0
361,Felipe Melo,br  BRA,"DF,MF",Fluminense,38,1983,8.1,8,5,5,3,0,4,14,28.6,10,11,9,2,11,19,27,0
362,Darlan Mendes,br  BRA,"MF,FW",Juventude,23,1998,1.3,1,1,1,0,0,0,0,,0,0,0,0,1,2,0,1
363,Vitor Mendes,br  BRA,DF,Juventude,22,1999,18.3,19,9,16,3,0,11,23,47.8,12,13,11,2,28,47,72,0
364,Stiven Mendoza,co  COL,FW,Ceará,29,1992,25.9,22,9,8,6,8,9,17,52.9,8,16,0,16,4,26,6,0
365,Ramon Menezes Roma,br  BRA,DF,Atl Goianiense,26,1995,14.0,7,3,6,1,0,2,8,25.0,6,7,7,0,15,22,50,0
366,Gabriel Menino,br  BRA,MF,Palmeiras,21,2000,10.2,21,16,11,9,1,10,16,62.5,6,7,1,6,12,33,12,0
367,Gabriel Mercado,ar  ARG,DF,Internacional,34,1987,23.6,30,21,26,4,0,21,30,70.0,9,28,18,10,30,60,79,0
368,John Mercado,ec  ECU,FW,Atl Paranaense,19,2002,0.0,0,0,0,0,0,0,0,,0,0,0,0,0,0,0,0
369,Miguel Merentiel,uy  URU,"FW,MF",Palmeiras,25,1996,2.6,1,0,1,0,0,1,1,100.0,0,0,0,0,0,1,0,0
370,Messias,br  BRA,DF,Ceará,27,1994,23.0,11,8,7,4,0,7,10,70.0,3,27,17,10,23,34,115,0
371,Lucas Mezenga,br  BRA,DF,Botafogo (RJ),20,2001,3.1,9,4,5,2,2,7,10,70.0,3,6,2,4,8,17,11,0
372,Michel,br  BRA,DF,Ceará,31,1990,11.8,10,8,5,3,2,3,7,42.9,4,6,4,2,15,25,22,0
373,Carlos Miguel,br  BRA,GK,Corinthians,23,1998,2.0,0,0,0,0,0,0,0,,0,0,0,0,0,0,0,1
374,Fernando Miguel,br  BRA,GK,Fortaleza,36,1985,20.0,0,0,0,0,0,0,0,,0,0,0,0,0,0,4,2
375,Miranda,br  BRA,DF,São Paulo,37,1984,12.8,18,15,16,2,0,11,18,61.1,7,17,9,8,13,31,67,0
376,Paulo Miranda,br  BRA,DF,Juventude,33,1988,16.4,6,4,6,0,0,2,5,40.0,3,21,18,3,22,28,89,0
377,Paulinho Moccelin,br  BRA,"MF,FW",Juventude,27,1994,4.3,13,7,7,6,0,10,27,37.0,17,9,0,9,4,17,7,0
378,Moisés,br  BRA,DF,Internacional,26,1995,6.5,8,8,5,3,0,6,7,85.7,1,3,1,2,6,14,18,0
379,Moises,br  BRA,"FW,MF",Fortaleza,25,1996,25.0,16,12,4,5,7,10,40,25.0,30,15,2,13,10,26,19,0
380,Rodrigo Moledo,br  BRA,DF,Internacional,34,1987,13.5,26,16,19,7,0,11,11,100.0,0,23,17,6,23,49,74,0
381,Jacob Montes,us  USA,MF,Botafogo (RJ),23,1998,1.0,2,1,1,1,0,0,1,0.0,1,2,1,1,1,3,1,0
382,Moraes,br  BRA,"DF,MF",Juventude,24,1997,15.2,26,19,17,8,1,13,21,61.9,8,9,4,5,31,57,33,0
383,Airton Moraes,br  BRA,GK,América (MG),27,1994,1.0,0,0,0,0,0,0,0,,0,0,0,0,0,0,0,0
384,Júnior Moraes,ua  UKR,FW,Corinthians,34,1987,4.5,5,4,1,2,2,1,4,25.0,3,4,1,3,2,7,0,0
385,Wesley Moraes,br  BRA,FW,Internacional,25,1996,3.3,0,0,0,0,0,0,1,0.0,1,2,0,2,0,0,4,0
386,Morato,br  BRA,"FW,MF",Avaí,29,1992,7.3,15,9,5,6,4,6,20,30.0,14,9,2,7,2,17,2,0
387,João Moreira,pt  POR,DF,São Paulo,17,2004,3.2,4,2,0,3,1,1,2,50.0,1,5,2,3,6,10,0,0
388,Lucas Moreira,br  BRA,"MF,FW",Cuiabá,21,2000,1.4,2,1,1,0,1,1,1,100.0,0,0,0,0,1,3,0,0
389,Gustavo Mosquito,br  BRA,"FW,MF",Corinthians,24,1997,12.6,14,4,4,5,5,7,13,53.8,6,4,1,3,4,18,11,1
390,Hugo Moura,br  BRA,MF,Atl Paranaense,24,1998,19.4,40,23,21,19,0,21,50,42.0,29,29,5,24,43,83,27,0
391,Alex Muralha,br  BRA,GK,Coritiba,32,1989,19.0,1,0,1,0,0,0,1,0.0,1,0,0,0,0,1,10,2
392,Muriqui,br  BRA,"FW,MF",Avaí,35,1986,14.3,20,6,4,14,2,9,24,37.5,15,11,0,11,10,30,5,0
393,Andrey Ramos do Nascimento,br  BRA,MF,Coritiba,23,1998,5.4,16,11,6,9,1,9,24,37.5,15,6,0,6,7,23,4,0
394,Matheus Nascimento,br  BRA,"FW,MF",Botafogo (RJ),17,2004,6.8,7,4,3,1,3,1,7,14.3,6,7,1,6,1,8,6,0
395,Natan,br  BRA,DF,Bragantino,20,2001,32.0,36,25,27,9,0,20,30,66.7,10,22,15,7,32,68,112,1
396,Léo Natel,br  BRA,FW,Corinthians,24,1997,0.3,1,0,0,1,0,1,1,100.0,0,0,0,0,0,1,0,0
397,Rafael Navarro,br  BRA,"FW,MF",Palmeiras,21,2000,8.0,15,9,2,9,4,2,7,28.6,5,6,0,6,0,15,2,0
398,Kaiky Naves,br  BRA,"DF,MF",Palmeiras,19,2002,0.4,0,0,0,0,0,0,0,,0,1,1,0,1,1,1,0
399,Bruno Nazário,br  BRA,MF,Juventude,26,1995,6.5,11,6,4,4,3,5,13,38.5,8,6,0,6,1,12,1,0
400,Neílton,br  BRA,"FW,DF",Coritiba,27,1994,0.9,1,1,1,0,0,1,1,100.0,0,3,0,3,1,2,0,0
401,Gabriel Neris,br  BRA,MF,Juventude,20,2001,2.4,4,1,0,3,1,1,4,25.0,3,5,3,2,4,8,1,0
402,Gustavo Nescau,br  BRA,FW,Cuiabá,21,2000,0.3,0,0,0,0,0,0,0,,0,0,0,0,0,0,1,0
403,Rodrigo Nestor,br  BRA,MF,São Paulo,21,2000,23.6,34,19,13,16,5,14,39,35.9,25,18,3,15,26,60,12,0
404,Gabriel Neves,uy  URU,MF,São Paulo,24,1997,6.3,13,11,6,6,1,8,22,36.4,14,7,1,6,9,22,11,0
405,Nicolas,br  BRA,"FW,MF",Goiás,32,1989,11.1,10,3,3,5,2,4,13,30.8,9,8,3,5,4,14,24,0
406,Nikão,br  BRA,"FW,MF",São Paulo,29,1992,5.8,2,1,1,1,0,0,6,0.0,6,2,0,2,1,3,4,0
407,Nino,br  BRA,DF,Fluminense,24,1997,27.9,28,21,20,6,2,12,20,60.0,8,27,17,10,31,59,93,0
408,Gabriel Noga,br  BRA,DF,Atl Goianiense,20,2002,0.0,,0,,,,,,,,,,,0,,,
409,Ygor Nogueira,br  BRA,DF,Juventude,26,1995,5.0,10,5,8,2,0,6,8,75.0,2,5,2,3,9,19,29,0
410,Nonato,br  BRA,MF,Fluminense,23,1998,12.1,23,14,4,14,5,13,28,46.4,15,16,3,13,12,35,9,0
411,Nonoca,br  BRA,MF,Avaí,23,1998,11.5,27,14,12,13,2,14,20,70.0,6,10,2,8,8,35,18,0
412,Gabriel Novaes,br  BRA,"FW,MF",Bragantino,22,1999,4.3,6,2,1,2,3,1,1,100.0,0,2,1,1,2,8,1,0
413,Thales Oleques,br  BRA,DF,Avaí,27,1994,6.2,12,6,7,5,0,7,12,58.3,5,6,3,3,4,16,26,0
414,Bruno Oliveira,br  BRA,"MF,FW",Santos,23,1998,5.0,7,4,1,3,3,3,16,18.8,13,3,0,3,2,9,3,0
415,Yuri Oliveira Lima,br  BRA,MF,Juventude,27,1994,16.8,31,15,16,13,2,11,37,29.7,26,17,6,11,20,51,14,0
416,Pedro Oliveira,br  BRA,"MF,FW",Goiás,17,2004,3.3,11,7,9,2,0,5,13,38.5,8,11,0,11,2,13,6,0
417,Leo Ortiz,br  BRA,DF,Bragantino,26,1996,21.4,22,11,12,9,1,17,25,68.0,8,36,25,11,27,49,97,1
418,Kelvin Osorio,co  COL,"MF,DF",Cuiabá,28,1993,10.5,21,14,11,10,0,13,30,43.3,17,8,0,8,8,29,16,0
419,Otávio,br  BRA,MF,Atlético Mineiro,27,1994,12.9,34,19,16,17,1,14,32,43.8,18,22,3,19,12,46,13,1
420,Luiz Otávio,br  BRA,DF,Ceará,33,1988,21.2,33,21,24,9,0,13,26,50.0,13,30,19,11,48,81,77,0
421,Rómulo Otero,ve  VEN,"MF,FW",Fortaleza,29,1992,2.6,2,1,1,1,0,1,2,50.0,1,3,0,3,0,2,0,0
422,Luis Oyama,br  BRA,MF,Botafogo (RJ),25,1997,12.0,31,17,17,11,3,17,44,38.6,27,19,4,15,17,48,14,1
423,Juan Pablo,br  BRA,"DF,MF",Goiás,19,2002,1.9,3,2,2,0,1,1,3,33.3,2,1,0,1,2,5,5,0
424,Juan Pablo Ramírez,co  COL,"MF,FW",América (MG),24,1997,4.5,7,3,1,5,1,3,5,60.0,2,3,0,3,4,11,2,0
425,Bruno Pacheco,br  BRA,DF,Ceará,30,1991,26.1,,33,,,,,,,,,,,28,,,
426,Igor Paixão,br  BRA,"FW,MF",Coritiba,21,2000,17.2,13,9,4,7,2,4,15,26.7,11,9,2,7,15,28,11,0
427,Pará,br  BRA,MF,Juventude,19,2002,0.9,2,1,0,2,0,1,1,100.0,0,0,0,0,1,3,2,0
428,Nino Paraíba,br  BRA,DF,Ceará,36,1986,24.6,43,22,26,13,4,13,22,59.1,9,25,3,22,36,79,46,0
429,Guilherme Parede,br  BRA,"FW,MF",Juventude,26,1995,6.6,,2,,,,,,,,,,,3,,,
430,Weslley Patati,br  BRA,FW,Santos,18,2003,0.2,,0,,,,,,,,,,,0,,,
431,Patrick,br  BRA,"MF,FW",São Paulo,29,1992,21.8,64,36,31,18,15,28,57,49.1,29,31,2,29,13,77,14,0
432,Alan Patrick,br  BRA,"MF,FW",Internacional,30,1991,17.5,12,3,2,8,2,6,24,25.0,18,10,0,10,6,18,4,0
433,Luan Patrick,br  BRA,DF,América (MG),20,2002,9.0,13,6,7,6,0,7,12,58.3,5,14,6,8,12,25,34,0
434,Patryck,br  BRA,DF,São Paulo,19,2003,0.3,1,1,1,0,0,1,1,100.0,0,0,0,0,0,1,0,0
435,Giuliano de Paula,br  BRA,MF,Corinthians,31,1990,18.4,20,13,8,12,0,12,40,30.0,28,15,2,13,10,30,16,0
436,Patrick de Paula,br  BRA,MF,Botafogo (RJ),22,1999,11.3,14,7,5,8,1,11,31,35.5,20,19,4,15,17,31,12,1
437,Paulão,br  BRA,DF,Cuiabá,35,1986,8.0,1,1,0,1,0,1,4,25.0,3,7,4,3,8,9,53,0
438,Caio Paulista,br  BRA,DF,Fluminense,23,1998,17.9,30,19,16,6,8,16,30,53.3,14,15,3,12,11,41,25,1
439,Wellington Paulista,br  BRA,FW,América (MG),37,1984,5.7,1,0,0,0,1,0,3,0.0,3,1,1,0,0,1,3,0
440,Marcos Paulo,br  BRA,DF,Flamengo,19,2003,0.3,2,2,2,0,0,2,3,66.7,1,2,1,1,2,4,0,0
441,Cristian Pavón,ar  ARG,"FW,MF",Atlético Mineiro,26,1996,7.7,12,7,4,3,5,9,20,45.0,11,13,0,13,3,15,2,0
442,Pedro,br  BRA,FW,Flamengo,24,1997,13.0,6,3,1,3,2,3,9,33.3,6,3,1,2,3,9,11,0
443,João Pedro,br  BRA,"DF,FW",Corinthians,25,1996,1.3,2,0,1,1,0,1,1,100.0,0,3,3,0,1,3,9,0
444,João Pedro Pepê,br  BRA,MF,Cuiabá,24,1998,25.8,60,34,29,22,9,14,49,28.6,35,24,3,21,17,77,28,0
445,Peglow,br  BRA,"FW,MF",Atl Goianiense,20,2002,2.6,5,4,2,1,2,3,9,33.3,6,4,0,4,4,9,3,0
446,Pegorari,br  BRA,GK,Juventude,30,1991,12.7,0,0,0,0,0,0,1,0.0,1,0,0,0,0,0,5,1
447,Matheus Peixoto,br  BRA,FW,Ceará,26,1995,5.2,6,3,1,4,1,2,6,33.3,4,4,2,2,2,8,4,0
448,Douglas Pelé,br  BRA,"FW,DF",Goiás,22,1999,1.0,2,2,2,0,0,0,0,,0,2,0,2,1,3,1,0
449,Léo Pelé,br  BRA,DF,São Paulo,25,1996,27.6,23,15,6,17,0,13,19,68.4,6,16,10,6,15,38,68,2
450,Carlos de Pena,uy  URU,"MF,FW",Internacional,29,1992,29.3,44,26,14,22,8,27,50,54.0,23,30,2,28,54,98,36,0
451,Andreas Pereira,br  BRA,MF,Flamengo,26,1996,8.8,8,5,1,4,3,3,16,18.8,13,7,0,7,4,12,7,0
452,Egídio Pereira Júnior,br  BRA,"DF,MF",Coritiba,35,1986,14.0,33,13,19,11,3,15,47,31.9,32,16,2,14,20,53,22,2
453,Léo Pereira,br  BRA,DF,Flamengo,26,1996,12.4,13,9,8,4,1,10,18,55.6,8,12,6,6,11,24,22,0
454,Hernán Pérez,py  PAR,FW,Coritiba,32,1989,1.1,2,0,1,1,0,2,6,33.3,4,1,1,0,0,2,0,0
455,Lucas Perri,br  BRA,GK,Botafogo (RJ),24,1997,3.8,0,0,0,0,0,0,0,,0,0,0,0,0,0,1,0
456,Petterson,br  BRA,"FW,MF",Flamengo,18,2004,0.3,0,0,0,0,0,0,0,,0,0,0,0,0,0,0,0
457,Yan Phillipe,br  BRA,FW,Atlético Mineiro,17,2004,0.2,0,0,0,0,0,0,0,,0,1,0,1,0,0,0,0
458,Lucas Piazon,br  BRA,"FW,MF",Botafogo (RJ),28,1994,8.3,21,9,5,13,3,5,12,41.7,7,5,0,5,2,23,11,0
459,Yago Pikachu,br  BRA,"DF,MF",Fortaleza,29,1992,13.4,11,9,10,0,1,5,17,29.4,12,11,3,8,5,16,8,0
460,Mario Pineida,ec  ECU,DF,Fluminense,29,1992,3.7,4,2,2,2,0,2,3,66.7,1,1,0,1,2,6,10,0
461,Joaquín Piquerez,uy  URU,DF,Palmeiras,23,1998,24.7,57,36,24,22,11,29,68,42.6,39,36,8,28,38,95,38,0
462,Felipe Pires,br  BRA,"MF,FW",Juventude,26,1995,7.4,3,1,0,1,2,1,3,33.3,2,3,0,3,0,3,2,0
463,Rafael Pires,br  BRA,GK,Atlético Mineiro,32,1989,1.0,0,0,0,0,0,0,0,,0,0,0,0,0,0,0,0
464,Lucas Piton,br  BRA,"DF,FW",Corinthians,21,2000,19.7,39,23,16,18,5,17,31,54.8,14,17,3,14,32,71,33,0
465,Isidro Pitta,py  PAR,FW,Juventude,22,1999,26.8,11,6,2,5,4,8,12,66.7,4,10,3,7,4,15,16,0
466,Luan Polli,br  BRA,GK,Atl Goianiense,28,1993,2.0,0,0,0,0,0,0,0,,0,0,0,0,0,0,4,0
467,Diego Porfirio,br  BRA,DF,Coritiba,22,1999,5.0,12,6,4,6,2,7,13,53.8,6,3,1,2,5,17,15,0
468,William Pottker,br  BRA,"FW,MF",Avaí,28,1993,21.9,17,11,9,6,2,10,25,40.0,15,18,1,17,17,34,15,0
469,Bruno Praxedes,br  BRA,MF,Bragantino,19,2002,6.5,6,3,0,5,1,1,6,16.7,5,4,1,3,4,10,2,0
470,Erick Pulgar,cl  CHI,MF,Flamengo,28,1994,3.9,8,3,2,6,0,3,8,37.5,5,8,1,7,3,11,8,0
471,Jean Pyerre,br  BRA,MF,Avaí,23,1998,8.4,9,4,3,6,0,3,8,37.5,5,8,0,8,7,16,1,0
472,Du Queiroz,br  BRA,MF,Corinthians,22,2000,28.9,52,29,22,26,4,15,59,25.4,44,37,11,26,33,85,18,0
473,Igor Rabello,br  BRA,DF,Atlético Mineiro,26,1995,6.7,12,5,11,1,0,8,11,72.7,3,12,8,4,14,26,21,0
474,Rafael,br  BRA,DF,Botafogo (RJ),31,1990,3.1,9,7,6,1,2,4,9,44.4,5,5,0,5,9,18,5,0
475,Caio Rafael,br  BRA,FW,Ceará,17,2004,0.4,0,0,0,0,0,0,0,,0,1,0,1,0,0,0,0
476,Léo Rafael,br  BRA,"FW,MF",Ceará,20,2001,1.0,1,0,0,1,0,1,2,50.0,1,0,0,0,0,1,0,0
477,Zé Rafael,br  BRA,MF,Palmeiras,28,1993,28.5,67,30,29,32,6,27,77,35.1,50,25,2,23,27,94,21,0
478,Rafinha,br  BRA,DF,São Paulo,36,1985,28.5,60,34,31,24,5,34,54,63.0,20,17,4,13,32,92,55,0
479,Eric Ramires,br  BRA,"MF,FW",Bragantino,21,2000,12.9,26,16,10,15,1,12,33,36.4,21,16,2,14,4,30,14,0
480,Lucas Ramires,br  BRA,DF,Juventude,19,2002,0.3,0,0,0,0,0,0,0,,0,0,0,0,0,0,1,0
481,Ramon,br  BRA,DF,Bragantino,20,2001,8.0,20,10,14,5,1,15,27,55.6,12,13,4,9,11,31,21,0
482,Lucas Ramos,br  BRA,"MF,FW",Internacional,21,2001,0.9,2,0,1,1,0,1,1,100.0,0,2,0,2,2,4,0,0
483,Rafael Ramos,pt  POR,DF,Corinthians,27,1995,14.5,35,23,25,9,1,18,32,56.3,14,15,2,13,19,54,31,0
484,Raniele,br  BRA,"MF,DF",Avaí,25,1996,31.3,61,33,30,25,6,30,63,47.6,33,56,25,31,39,100,106,1
485,Wellington Rato,br  BRA,"FW,MF",Atl Goianiense,29,1992,30.9,29,22,16,10,3,15,46,32.6,31,18,3,15,10,39,24,0
486,Raul,br  BRA,MF,Bragantino,25,1996,27.5,72,42,36,34,2,43,75,57.3,32,34,11,23,48,120,41,0
487,Pedro Raul,br  BRA,FW,Goiás,25,1996,30.5,13,9,2,8,3,5,18,27.8,13,19,4,15,4,17,41,0
488,Leonardo Realpe,ec  ECU,DF,Bragantino,20,2001,7.4,7,3,5,2,0,5,9,55.6,4,11,8,3,15,22,34,0
489,Rafinha Rech,br  BRA,"FW,MF",Juventude,19,2002,4.2,2,2,1,0,1,1,5,20.0,4,8,0,8,4,6,2,0
490,Régis,br  BRA,MF,Coritiba,29,1992,8.5,18,10,6,8,4,8,20,40.0,12,10,0,10,1,19,4,0
491,Reinaldo,br  BRA,"DF,FW",São Paulo,32,1989,16.3,16,12,7,7,2,7,16,43.8,9,15,2,13,10,26,22,0
492,César Reis,br  BRA,GK,Juventude,26,1995,24.3,0,0,0,0,0,0,0,,0,0,0,0,0,0,11,1
493,Renan,br  BRA,DF,Bragantino,19,2002,3.2,8,3,7,1,0,6,7,85.7,1,6,3,3,2,10,14,0
494,Robert Renan,br  BRA,DF,Corinthians,18,2003,10.0,17,11,11,5,1,11,15,73.3,4,8,5,3,19,36,51,0
495,Renato,br  BRA,"DF,MF",Avaí,32,1990,11.3,14,9,6,7,1,9,12,75.0,3,13,2,11,8,22,24,0
496,Renê,br  BRA,DF,Internacional,29,1992,27.5,80,49,44,30,6,43,69,62.3,26,27,8,19,52,132,75,1
497,Réver,br  BRA,DF,Atlético Mineiro,37,1985,10.5,13,9,9,2,2,5,9,55.6,4,7,5,2,12,25,40,0
498,Rhaldney,br  BRA,"MF,FW",Atl Goianiense,23,1998,2.0,10,4,5,4,1,5,8,62.5,3,3,0,3,2,12,5,0
499,Everton Ribeiro,br  BRA,"MF,FW",Flamengo,32,1989,19.9,44,20,18,16,10,13,44,29.5,31,22,2,20,19,63,6,1
500,Lucas Ribeiro,br  BRA,"DF,MF",Ceará,23,1999,5.6,5,0,3,2,0,0,3,0.0,3,3,2,1,9,14,12,0
501,Matheus Ribeiro,br  BRA,DF,Avaí,28,1993,0.2,1,1,0,1,0,0,0,,0,1,1,0,0,1,0,0
502,Wesley Ribeiro,br  BRA,"MF,FW",Corinthians,16,2005,0.1,0,0,0,0,0,0,1,0.0,1,0,0,0,0,0,0,0
503,Ricardinho,br  BRA,FW,Atl Goianiense,20,2001,2.6,0,0,0,0,0,0,2,0.0,2,2,0,2,0,0,0,0
504,João Ricardo Riedi,br  BRA,GK,Ceará,33,1988,35.0,1,1,1,0,0,1,3,33.3,2,0,0,0,0,1,18,3
505,Vitor Ricardo,br  BRA,DF,Fortaleza,21,2000,1.3,2,2,2,0,0,1,3,33.3,2,1,0,1,0,2,0,0
506,Zé Ricardo,br  BRA,MF,América (MG),25,1996,2.6,3,2,2,1,0,1,3,33.3,2,4,1,3,5,8,5,0
507,Richardson,br  BRA,MF,Ceará,30,1991,23.0,62,31,27,26,9,32,69,46.4,37,20,4,16,20,82,20,2
508,Rickson,br  BRA,"MF,FW",Atl Goianiense,23,1998,0.8,2,2,2,0,0,0,3,0.0,3,3,1,2,0,2,0,0
509,Emiliano Rigoni,ar  ARG,"FW,MF",São Paulo,28,1993,2.7,5,3,2,2,1,2,6,33.3,4,5,0,5,2,7,3,0
510,Rikelme,br  BRA,DF,Cuiabá,18,2003,0.2,1,0,0,1,0,1,1,100.0,0,1,0,1,1,2,0,0
511,Rikelmi,br  BRA,DF,Botafogo (RJ),20,2001,0.0,0,0,0,0,0,0,0,,0,0,0,0,0,0,0,0
512,Cristian Rivas,ve  VEN,MF,Cuiabá,25,1997,2.4,6,1,3,3,0,4,10,40.0,6,1,0,1,5,11,1,0
513,Zé Roberto,br  BRA,FW,Ceará,28,1993,8.2,4,2,0,4,0,2,3,66.7,1,9,2,7,7,11,5,0
514,Robinho,br  BRA,MF,Coritiba,34,1987,9.8,34,17,15,13,6,18,36,50.0,18,3,0,3,6,40,2,0
515,Robson,br  BRA,"FW,MF",Fortaleza,30,1991,16.1,14,12,5,6,3,4,20,20.0,16,15,4,11,6,20,19,0
516,Felipe Rocha,br  BRA,FW,Avaí,19,2002,0.5,1,0,1,0,0,1,2,50.0,1,0,0,0,0,1,1,0
517,Kaique Rocha,br  BRA,DF,Internacional,20,2001,5.0,5,2,2,3,0,3,6,50.0,3,3,2,1,9,14,23,0
518,Marcos Rocha,br  BRA,DF,Palmeiras,33,1988,25.0,87,54,36,43,8,37,70,52.9,33,28,8,20,31,118,42,0
519,Rodinei,br  BRA,DF,Flamengo,30,1992,9.8,26,17,8,14,4,16,18,88.9,2,7,3,4,13,39,6,0
520,Élton Rodrigues Brandão,br  BRA,FW,Cuiabá,36,1985,3.3,3,1,2,1,0,1,3,33.3,2,3,0,3,0,3,3,0
521,Raphael Rodrigues,br  BRA,DF,Avaí,23,1999,1.4,1,0,1,0,0,0,0,,0,3,2,1,0,1,5,0
522,Rodriguinho,br  BRA,MF,América (MG),18,2003,2.1,4,3,2,2,0,1,7,14.3,6,1,0,1,5,9,0,0
523,Romarinho,br  BRA,"FW,MF",Fortaleza,27,1994,14.6,13,11,3,7,3,7,21,33.3,14,5,0,5,4,17,7,0
524,Braian Romero,ar  ARG,FW,Internacional,30,1991,3.8,10,6,0,7,3,4,10,40.0,6,4,2,2,1,11,3,0
525,Silvio Romero,ar  ARG,FW,Fortaleza,33,1988,12.9,2,2,1,0,1,0,6,0.0,6,4,0,4,2,4,11,0
526,Romulo,br  BRA,DF,Juventude,21,2000,1.9,3,1,3,0,0,2,4,50.0,2,4,3,1,2,5,5,0
527,Ronald,br  BRA,"MF,FW",Fortaleza,24,1997,11.7,26,17,13,11,2,13,27,48.1,14,7,0,7,8,34,4,0
528,Ronaldo,br  BRA,GK,Atl Goianiense,25,1996,18.0,3,0,3,0,0,3,3,100.0,0,2,0,2,0,3,8,0
529,Budiga Roni,br  BRA,MF,Corinthians,22,1999,8.3,20,14,6,12,2,8,22,36.4,14,9,2,7,7,27,8,0
530,Rony,br  BRA,FW,Palmeiras,26,1995,26.5,18,8,3,9,6,5,27,18.5,22,16,1,15,7,25,20,0
531,Vitor Roque,br  BRA,FW,Atl Paranaense,16,2005,14.6,17,9,4,6,7,4,9,44.4,5,10,0,10,9,26,1,0
532,Ruan,br  BRA,"FW,MF",Juventude,16,2005,2.5,7,5,3,2,2,3,5,60.0,2,3,0,3,0,7,0,0
533,Rubens,br  BRA,"DF,MF",Atlético Mineiro,20,2001,13.7,63,31,31,24,8,26,43,60.5,17,17,1,16,21,84,28,0
534,Óscar Ruiz,py  PAR,"MF,FW",Juventude,30,1991,11.0,11,7,4,6,1,4,9,44.4,5,9,0,9,5,16,8,0
535,Rwan,br  BRA,"FW,MF",Santos,20,2001,5.2,7,5,1,3,3,3,7,42.9,4,6,1,5,4,11,3,0
536,João Victor Santos Sá,br  BRA,FW,Botafogo (RJ),27,1994,19.4,38,24,19,13,6,24,60,40.0,36,29,3,26,16,54,9,0
537,Matheus Sales,br  BRA,"MF,DF",Goiás,26,1995,19.9,42,24,22,15,5,18,30,60.0,12,34,17,17,16,58,45,0
538,Philipe Sampaio,br  BRA,DF,Botafogo (RJ),27,1994,12.5,12,8,8,4,0,10,17,58.8,7,16,15,1,27,39,65,0
539,Carlos Sánchez,uy  URU,MF,Santos,37,1984,8.7,12,8,5,4,3,5,16,31.3,11,10,2,8,5,17,4,0
540,Sandry,br  BRA,MF,Santos,19,2002,7.7,24,14,6,17,1,10,27,37.0,17,16,1,15,11,35,7,0
541,Alex Santana,br  BRA,MF,Atl Paranaense,26,1995,9.9,18,8,9,9,0,9,22,40.9,13,11,3,8,12,30,14,0
542,Santos,br  BRA,GK,Flamengo,31,1990,19.0,0,0,0,0,0,0,0,,0,0,0,0,0,0,9,0
543,Ademir Santos,br  BRA,"FW,MF",Atlético Mineiro,26,1995,16.6,29,18,14,7,8,13,42,31.0,29,27,2,25,8,37,8,0
544,Chayene Santos,br  BRA,"MF,FW",Botafogo (RJ),31,1990,6.5,13,9,4,5,4,7,17,41.2,10,10,0,10,5,18,1,0
545,Fábio Santos,br  BRA,DF,Corinthians,36,1985,17.4,21,15,9,10,2,16,32,50.0,16,18,5,13,19,40,48,0
546,Guilherme Santos,br  BRA,"FW,MF",Bragantino,20,2001,0.5,1,0,1,0,0,1,2,50.0,1,0,0,0,0,1,0,0
547,Gustavo Santos,br  BRA,FW,Avaí,19,2002,0.2,,0,,,,,,,,,,,0,,,
548,Juan Santos,br  BRA,FW,São Paulo,19,2002,0.6,0,0,0,0,0,0,0,,0,2,1,1,0,0,0,0
549,Júnior Santos,br  BRA,"FW,MF",Botafogo (RJ),27,1994,11.9,16,13,11,4,1,6,16,37.5,10,16,0,16,2,18,13,0
550,Luis Eduardo Marques dos Santos,br  BRA,DF,Atl Goianiense,24,1997,18.2,36,19,25,6,5,27,45,60.0,18,28,12,16,26,62,44,1
551,Matheus Santos,br  BRA,MF,Goiás,23,1998,0.1,0,0,0,0,0,0,0,,0,1,0,1,0,0,0,0
552,Rafael Santos,br  BRA,DF,Coritiba,23,1998,12.7,24,9,13,8,3,11,17,64.7,6,5,3,2,7,31,36,0
553,Mateus Sarará,br  BRA,MF,Avaí,19,2002,4.8,8,3,3,3,2,4,6,66.7,2,6,4,2,4,12,12,0
554,Renzo Saravia,ar  ARG,"DF,MF",Botafogo (RJ),28,1993,20.2,48,31,30,16,2,33,70,47.1,37,27,5,22,32,80,36,2
555,Eduardo Sasha,br  BRA,"FW,MF",Atlético Mineiro,29,1992,14.3,8,6,4,4,0,3,8,37.5,5,12,1,11,6,14,7,0
556,Lucas Sasha,br  BRA,MF,Fortaleza,31,1990,14.1,66,46,30,33,3,24,47,51.1,23,22,5,17,20,86,35,1
557,Gustavo Sauer,br  BRA,"FW,MF",Botafogo (RJ),28,1993,3.2,6,3,2,3,1,3,9,33.3,6,5,0,5,1,7,1,0
558,Jefferson Savarino,ve  VEN,FW,Atlético Mineiro,25,1996,1.0,1,1,1,0,0,0,0,,0,0,0,0,0,1,0,0
559,Sávio,br  BRA,"FW,MF",Atlético Mineiro,17,2004,2.4,3,1,1,2,0,2,8,25.0,6,2,0,2,3,6,0,0
560,Savio,br  BRA,DF,Goiás,26,1995,9.4,20,12,16,3,1,12,25,48.0,13,5,1,4,6,26,24,0
561,Gustavo Scarpa,br  BRA,"MF,FW",Palmeiras,28,1994,28.6,18,10,8,8,2,3,21,14.3,18,9,1,8,13,31,15,0
562,Cleiton Schwengber,br  BRA,GK,Bragantino,24,1997,37.0,1,1,1,0,0,0,3,0.0,3,1,0,1,0,1,25,5
563,Shaylon,br  BRA,"FW,MF",Atl Goianiense,24,1997,15.0,17,9,7,6,4,6,17,35.3,11,12,1,11,5,22,9,0
564,Sidcley,br  BRA,"DF,MF",Cuiabá,28,1993,3.7,1,1,0,1,0,1,2,50.0,1,5,0,5,9,10,3,0
565,Sidimar,br  BRA,DF,Goiás,29,1992,5.0,10,4,9,0,1,4,5,80.0,1,5,4,1,8,18,27,0
566,Sidnei,br  BRA,DF,Goiás,32,1989,3.3,3,3,3,0,0,2,3,66.7,1,1,1,0,7,10,20,0
567,Pablo Siles,uy  URU,MF,Atl Paranaense,24,1997,1.8,5,1,1,1,3,4,8,50.0,4,4,3,1,3,8,0,0
568,Aderlan Silva,br  BRA,DF,Bragantino,31,1990,29.7,94,62,46,34,14,46,92,50.0,46,40,11,29,45,139,60,1
569,Bruno Silva,br  BRA,MF,Avaí,35,1986,28.9,88,52,43,40,5,43,96,44.8,53,48,8,40,30,118,60,0
570,Da Silva,br  BRA,DF,Goiás,20,2001,6.3,5,3,2,3,0,2,3,66.7,1,8,6,2,7,12,37,1
571,Cristiano da Silva Leite,br  BRA,DF,Fluminense,28,1993,8.3,15,8,5,6,4,8,10,80.0,2,5,1,4,10,25,13,0
572,Felipe Silva Lipe,br  BRA,DF,Avaí,19,2002,3.0,5,5,4,1,0,2,2,100.0,0,1,1,0,9,14,15,1
573,Lucas Silva,br  BRA,"FW,MF",Avaí,24,1998,1.2,2,0,1,1,0,1,1,100.0,0,1,0,1,2,4,1,0
574,Marcão Silva,br  BRA,"MF,DF",Cuiabá,31,1991,14.1,32,16,13,15,4,17,28,60.7,11,23,4,19,11,43,44,0
575,Márcio Silva,br  BRA,DF,Coritiba,20,2001,2.0,1,1,0,1,0,0,1,0.0,1,7,4,3,1,2,12,0
576,Nathan Silva,br  BRA,DF,Atlético Mineiro,24,1997,19.2,24,14,15,9,0,9,13,69.2,4,17,12,5,29,53,76,0
577,Ricardo Silva,br  BRA,DF,América (MG),29,1992,8.3,9,6,5,3,1,7,11,63.6,4,12,10,2,7,16,41,0
578,Miguel Silveira,br  BRA,"MF,FW",Bragantino,18,2003,6.3,12,6,6,2,4,5,15,33.3,10,9,0,9,1,13,2,0
579,Vinicius Silvestre,br  BRA,GK,Palmeiras,27,1994,1.0,0,0,0,0,0,0,0,,0,0,0,0,0,0,0,0
580,Jailson Siqueira,br  BRA,MF,Palmeiras,26,1995,0.2,0,0,0,0,0,0,2,0.0,2,0,0,0,0,0,0,0
581,Everton Soares,br  BRA,"FW,MF",Flamengo,25,1996,15.7,22,13,3,9,10,6,12,50.0,6,8,0,8,6,28,2,0
582,Tiquinho Soares,br  BRA,FW,Botafogo (RJ),31,1991,13.7,7,4,0,7,0,5,7,71.4,2,3,1,2,2,9,13,0
583,Fernando Sobral,br  BRA,MF,Ceará,27,1994,11.2,27,22,17,7,3,16,36,44.4,20,20,5,15,4,31,14,0
584,Yeferson Soteldo,ve  VEN,"FW,MF",Santos,24,1997,6.3,5,0,0,3,2,3,12,25.0,9,1,0,1,1,6,0,0
585,Yan Souto,br  BRA,DF,Goiás,20,2001,6.8,6,4,4,2,0,3,7,42.9,4,11,9,2,11,17,49,0
586,Hugo Souza,br  BRA,GK,Flamengo,23,1999,14.3,1,1,1,0,0,1,2,50.0,1,0,0,0,1,2,7,1
587,Igor Vinícius de Souza,br  BRA,"DF,FW",São Paulo,24,1997,12.9,42,24,20,15,7,18,37,48.6,19,11,3,8,12,54,13,0
588,Bruno Tabata,br  BRA,FW,Palmeiras,24,1997,5.2,,5,,,,,,,,,,,2,,,
589,Tadeu,br  BRA,GK,Goiás,29,1992,38.0,0,0,0,0,0,0,0,,0,2,0,2,2,2,17,0
590,Tailson,br  BRA,"FW,DF",Santos,22,1999,0.4,1,0,0,1,0,0,1,0.0,1,0,0,0,1,2,0,0
591,Taison,br  BRA,"MF,FW",Internacional,34,1988,8.1,8,7,3,5,0,5,15,33.3,10,5,0,5,7,15,3,0
592,Tchê Tchê,br  BRA,MF,Botafogo (RJ),29,1992,25.7,29,18,9,20,0,9,32,28.1,23,15,3,12,27,56,16,1
593,David Terans,uy  URU,MF,Atl Paranaense,27,1994,22.3,19,10,4,12,3,6,21,28.6,15,10,0,10,5,24,1,0
594,Miguel Terceros,bo  BOL,FW,Santos,17,2004,0.3,1,1,0,1,0,1,1,100.0,0,0,0,0,0,1,0,0
595,Thiago,br  BRA,GK,São Paulo,22,1999,2.7,0,0,0,0,0,0,0,,0,0,0,0,0,0,0,1
596,Guilherme Tinga,br  BRA,DF,Fortaleza,28,1993,13.1,32,17,22,9,1,21,28,75.0,7,10,7,3,19,51,49,0
597,Titi,br  BRA,DF,Fortaleza,33,1988,31.1,32,21,24,8,0,20,31,64.5,11,15,14,1,43,75,84,0
598,Igor Torres,br  BRA,"FW,MF",Fortaleza,21,2000,0.1,1,0,1,0,0,1,1,100.0,0,0,0,0,0,1,0,0
599,Jesús Trindade,uy  URU,MF,Coritiba,28,1993,14.6,34,17,17,15,2,16,34,47.1,18,15,4,11,10,44,12,0
600,Bruno Tubarão,br  BRA,"FW,MF",Bragantino,26,1995,5.0,8,3,3,2,3,3,12,25.0,9,3,0,3,6,14,2,0
601,Uendel,br  BRA,DF,Cuiabá,33,1988,14.7,19,8,13,6,0,13,23,56.5,10,14,0,14,10,29,27,0
602,Valdemir,br  BRA,MF,Coritiba,24,1997,6.9,20,12,15,4,1,13,23,56.5,10,8,3,5,9,29,11,0
603,Valdívia,br  BRA,"MF,FW",Cuiabá,27,1994,15.4,19,10,9,8,2,5,18,27.8,13,9,1,8,8,27,8,0
604,Vanderlan,br  BRA,DF,Palmeiras,19,2002,7.2,17,9,9,6,2,6,10,60.0,4,2,1,1,18,35,11,0
605,Guillermo Varela,uy  URU,DF,Flamengo,28,1993,2.9,6,4,3,3,0,3,3,100.0,0,1,1,0,8,14,7,0
606,Eduardo Vargas,cl  CHI,FW,Atlético Mineiro,32,1989,12.7,6,6,2,2,2,3,9,33.3,6,11,0,11,4,10,8,0
607,Matheus de Vargas,br  BRA,MF,Fortaleza,25,1996,4.6,6,2,1,5,0,3,12,25.0,9,4,1,3,3,9,3,0
608,Jhon Vasquez,co  COL,"FW,MF",Ceará,26,1995,4.6,7,5,2,5,0,5,10,50.0,5,4,0,4,1,8,3,0
609,Rafael Vaz,br  BRA,DF,Avaí,33,1988,15.5,17,9,14,3,0,12,23,52.2,11,16,12,4,12,29,69,0
610,Raphael Veiga,br  BRA,MF,Palmeiras,26,1995,14.0,14,10,2,9,3,7,17,41.2,10,6,0,6,3,17,6,0
611,Emiliano Velázquez,uy  URU,DF,Santos,27,1994,6.0,11,9,8,3,0,6,12,50.0,6,5,3,2,14,25,22,0
612,Fausto Vera,ar  ARG,MF,Corinthians,21,2000,14.5,37,22,19,14,4,18,37,48.6,19,23,11,12,18,55,26,1
613,Gabriel Veron,br  BRA,"FW,MF",Palmeiras,19,2002,6.3,14,8,8,6,0,10,12,83.3,2,4,0,4,6,20,3,0
614,João Vialle,br  BRA,DF,Atl Paranaense,19,2002,0.3,0,0,0,0,0,0,0,,0,0,0,0,0,0,0,0
615,Marcos Victor,br  BRA,DF,Ceará,20,2001,4.0,7,4,7,0,0,6,6,100.0,0,4,3,1,8,15,14,1
616,Arturo Vidal,cl  CHI,MF,Flamengo,34,1987,9.3,23,16,8,10,5,13,27,48.1,14,11,1,10,21,44,7,0
617,Caio Vidal,br  BRA,"FW,MF",Internacional,21,2000,1.7,3,2,2,0,1,2,5,40.0,3,0,0,0,3,6,1,0
618,Elvis Vieira Araújo,br  BRA,"MF,FW",Goiás,31,1990,9.4,6,4,3,2,1,3,17,17.6,14,3,0,3,6,12,1,0
619,Gabriel Vieira,br  BRA,FW,Palmeiras,19,2002,0.1,0,0,0,0,0,0,0,,0,0,0,0,0,0,0,0
620,Luan Vieira,br  BRA,"MF,FW",Santos,28,1993,5.0,5,4,1,3,1,3,8,37.5,5,5,3,2,1,6,0,0
621,Marcos Vinicios Sorriso,br  BRA,FW,Bragantino,20,2001,15.0,25,15,11,10,4,11,24,45.8,13,24,4,20,8,33,13,0
622,Caio Vinícius,br  BRA,MF,Goiás,23,1999,17.3,45,23,16,20,9,12,35,34.3,23,25,3,22,30,75,41,0
623,Mateus Vital,br  BRA,"FW,MF",Corinthians,23,1998,8.2,21,13,7,8,6,7,18,38.9,11,3,1,2,7,28,1,0
624,Vitão,br  BRA,DF,Internacional,21,2000,31.0,32,14,25,7,0,22,31,71.0,9,39,30,9,19,51,161,0
625,João Vitor,br  BRA,MF,Coritiba,21,2000,0.1,0,0,0,0,0,0,0,,0,0,0,0,0,0,0,0
626,Vladimir,br  BRA,GK,Avaí,32,1989,22.5,2,0,2,0,0,2,2,100.0,0,0,0,0,0,2,7,0
627,Max Walef,br  BRA,GK,Fortaleza,28,1993,5.0,0,0,0,0,0,0,0,,0,0,0,0,0,0,3,1
628,Walter,br  BRA,GK,Cuiabá,34,1987,27.4,2,2,2,0,0,2,2,100.0,0,0,0,0,1,3,10,0
629,Warley,br  BRA,"FW,MF",Coritiba,22,1999,6.2,5,4,3,2,0,3,8,37.5,5,3,1,2,9,14,12,0
630,Welington,br  BRA,"DF,FW",São Paulo,20,2001,18.6,34,21,20,9,5,14,35,40.0,21,15,1,14,15,49,36,0
631,José Welison,br  BRA,MF,Fortaleza,26,1995,19.1,37,22,12,20,5,13,27,48.1,14,24,6,18,38,75,29,0
632,Weliton,cl  CHI,MF,Juventude,16,2005,0.0,0,0,0,0,0,0,0,,0,0,0,0,0,0,1,0
633,Wellington,br  BRA,DF,Avaí,26,1995,3.0,2,2,2,0,0,2,4,50.0,2,3,2,1,5,7,15,0
634,Welliton,br  BRA,"MF,FW",Bragantino,21,2000,1.1,5,3,0,2,3,3,6,50.0,3,1,0,1,0,5,1,0
635,Wendell,br  BRA,MF,Ceará,19,2002,0.1,1,1,0,0,1,0,0,,0,0,0,0,1,2,1,0
636,Werik,br  BRA,FW,Bragantino,20,2001,5.7,2,2,1,1,0,1,2,50.0,1,9,0,9,0,2,6,0
637,Werton,br  BRA,FW,Flamengo,18,2003,0.3,3,1,1,0,2,2,2,100.0,0,0,0,0,0,3,2,0
638,Wescley,br  BRA,MF,Ceará,30,1991,0.8,3,2,2,1,0,1,2,50.0,1,0,0,0,0,3,0,0
639,Wesley,br  BRA,FW,Palmeiras,22,1999,7.2,9,6,4,1,4,4,8,50.0,4,5,0,5,3,12,5,0
640,Weverson,br  BRA,MF,Bragantino,21,2000,0.5,0,0,0,0,0,0,0,,0,0,0,0,0,0,0,0
641,Weverton,br  BRA,DF,Internacional,22,1999,0.5,0,0,0,0,0,0,0,,0,2,1,1,0,0,1,0
642,Wéverton,br  BRA,GK,Palmeiras,34,1987,34.0,1,1,1,0,0,1,3,33.3,2,0,0,0,1,2,9,0
643,Rafael William,br  BRA,GK,Coritiba,20,2001,6.0,0,0,0,0,0,0,0,,0,0,0,0,0,0,3,1
644,Xavier,br  BRA,MF,Corinthians,21,2000,1.8,3,1,2,1,0,3,4,75.0,1,0,0,0,2,5,9,0
645,Samuel Xavier,br  BRA,DF,Fluminense,31,1990,31.4,32,16,18,11,3,20,36,55.6,16,34,8,26,26,58,58,0
646,Yago,br  BRA,"MF,DF",Fluminense,26,1995,12.6,22,13,6,13,3,15,23,65.2,8,20,6,14,13,35,12,0
647,Ytalo,br  BRA,FW,Bragantino,34,1988,6.9,3,3,0,1,2,1,4,25.0,3,7,1,6,3,6,5,0
648,Marcos Ytalo,br  BRA,DF,Ceará,25,1996,1.8,4,3,2,2,0,0,2,0.0,2,1,0,1,2,6,2,0
649,Vinícius Zanocelo,br  BRA,MF,Santos,21,2001,22.3,29,17,13,14,2,10,46,21.7,36,28,8,20,24,53,36,0
650,Federico Zaracho,ar  ARG,"MF,FW",Atlético Mineiro,23,1998,20.9,52,29,19,22,11,20,62,32.3,42,33,2,31,22,74,17,0
